Throw away the chairs whose legs are broken.	en
I adore going to the cinema.	en
Passport, please.	en
Nancy told me about the fire.	en
What are some other nabemono?	en
Which team will win?	en
The man robbed the old man of the bag.	en
Il laissa son chien courir librement dans le champ.	fr
The issue is quite familiar to us.	en
He won but only at a price.	en
He will without doubt succeed in the exam.	en
He is a man of virtue.	en
She appears to have been rich.	en
Ich habe zufällig meinen alten Freund am Bahnhof von Tokyo getroffen.	de
Nie ma powodu, bym tego nie robił.	pl
我們已經做好了最壞的準備。	zh
我能借你的车吗？	zh
¿Cuánto tiempo?	es
禁止入内。	zh
Dieser Betrag beinhaltet die Steuer.	de
Mi ne trovas la ĝustajn vortojn por esprimi mian dankon.	ep
In order to improve the environment.	en
J'aurai terminé le travail avant que tu ne reviennes.	fr
Könnten Sie mir ein Taxi bestellen?	de
That guy is completely nuts!	en
Sie bat ihn, das Fenster zu öffnen.	de
Li ofte veturas al la biblioteko.	ep
Le gosse est une plaie.	fr
Plus du tiers de la population mondiale vit près d'une côte.	fr
Mi ŝuldas al vi 3000 enojn.	ep
Jej wiara w Boga była bardzo silna.	pl
Wir hielten es für eine fliegende Untertasse.	de
¿Por qué tardas tanto en comer?	es
Please put your waste in the bins outside.	en
Je bent nooit te oud om te leren.	nl
Wollt ihr mit mir schlafen?	de
Jutro powinna być piękna pogoda.	pl
Naprawdę piękna pogoda.	pl
Mutti kocht in der Küche.	de
Самая высокая гора Европы — Эльбрус.	ru
Dio kreis Padanion kaj, konstatinte la eraron, kovris ĝin per nebulo.	ep
Le gustan las naranjas.	es
La kafo estas nur varmeta.	ep
我們在那裡上了公共汽車。	zh
Wie können da unbeschädigte Eier unter einem umgestürzten Nest sein?	de
J'ai acheté des fringues.	fr
Aptal parasını çabuk harcar.	tr
Hisleri, görüntüleri, düşünceleri ya da anıları iletmeyen müzik sadece arka fon gürültüsüdür.	tr
È arrivato a mezzanotte.	it
Je vous appelle pour prendre rendez-vous avec vous.	fr
Dices "pobre", pero hay muchos grados de pobreza.	es
Jeden z tych chłopców to wie.	pl
Je suis daltonien.	fr
He gets on my nerves!	en
Tu aimes ces chaussures.	fr
Les nôtres nous approuvent.	fr
Tom doesn't enjoy family gatherings very much.	en
Seu rosto parece ao da mãe.	pt
Men moet een helm opzetten om het hoofd te beschermen.	nl
Habarovsk, Rus Uzak Doğusu'nun en büyük şehirleri arasındadır.	tr
Sinun pitäisi soittaa vanhemmillesi edes kerran kuukaudessa.	fi
Eroavatkohan he?	fi
Tom'un niyeti bunun olması değildi.	tr
Não dá para estudar com tanto barulho!	pt
A zombie brain will eat itself.	en
O gerçekten üzücüdür.	tr
Lui vive accanto a me.	it
O doğru olmak zorundadır.	tr
Nerede gizli?	tr
La tragikaj eventoj je la dekunua de septembro markis la mondan historion.	ep
Ég er heilsuhraustur.	is
A capital da Sérvia é Belgrado.	pt
Eblas kalkuli la mason de Tero uzante formulon, kiu inkluzivas la daŭron de la rondiro de Luno ĉirkaŭ Tero, la meza disto inter Tero kaj Luno, la universala gravita konstanto kaj la nombro π.	ep
Sie erhielt gute Noten in Mathematik.	de
Qual è la sua canzone di Natale preferita?	it
Он всё время орёт на своих детей.	ru
La du viroj komprenis unu la alian perfekte, kaj havis reciprokan respekton al la fortaj kvalitoj unu de la alia.	ep
Drakoj estas estaĵoj longaj kiel serpentoj, havantaj flugilojn kiel birdoj, kaj inteligentaj kiel homoj.	ep
Onun tam olarak niyet ettiği oydu.	tr
Tiu kulero estas por supo.	ep
Keinem außer mir kann ich die Schuld geben.	de
Его речь взволновала нас.	ru
Ŝparu kandelon por nokto.	ep
Déjame decirte algo.	es
Si hubiera ahorrado, ahora no tendría que vender el coche.	es
Söylediğinin doğru olduğunu kanıtlayabilir misin?	tr
Ontem esqueci a carteira.	pt
Die Wanderer waren praktisch eingefroren, als man sie fand.	de
Per piacere, cambi la bandiera.	it
I didn't like the way she talked to people.	en
Mariko jól beszél angolul.	hu
La femme qui se tient là-bas est la plus belle femme que j'ai jamais vue.	fr
Yarına kadar ev ödevini teslim etmeyi unutma.	tr
Das Boot war mit einem Tau am Ufer festgebunden.	de
Tom fragte mich, ob ich mit ihm am Samstag Fahrrad fahren könne.	de
Ne "li estas mia filo" sed "mi estas lia patro".	ep
Bu tiyatroda alkol içmememiz gerekiyor.	tr
Tom sagt, er könne nichts mehr essen.	de
Ich erinnere mich, den Film schon gesehen zu haben.	de
Ĝi pligrandiĝas.	ep
Ich war dumm genug, um es zu machen.	de
मी ब्राजिलपासून आलेय.	ma
Tom llevaba una corbata roja y blanca a rayas.	es
Özür dilerim, o bilgiyi size vermeye izinli değilim.	tr
No viertas agua caliente en el vaso, podría quebrarse.	es
En tehnyt mitään väärää.	fi
Instigoj estas ĉiam bonvenaj.	ep
Non potevo proprio dire di no.	it
Ein Junggeselle ist ein Mann, der nicht gleich eine Farm kauft, wenn er ein Hühnerei braucht.	de
There she stands.	en
Они хотят, в первую очередь, жить мирно.	ru
Ihr Lebensraum ist durch Abholzung bedroht.	de
Io uso Twitter.	it
Просто използвай моя засега.	bg
La laboroj komenciĝos morgaŭ.	ep
The government's decision had disastrous economic consequences.	en
Je veux t'entendre hurler.	fr
Разве вы не видите, что мы разговариваем?	ru
Mary manĝas pli malmulte ol sia fratino.	ep
He just wants my attention.	en
Tom si sta sentendo frastornato.	it
Van néhány könyv az asztalon.	hu
Vil du gøre mig en tjeneste?	dk
Que sais-tu de la patience, d'abord ?	fr
I'm sending Tom home.	en
The fry does not need to be taught to swim.	en
Tom yaralı görünüyor.	tr
Я хочу, чтобы все показали мне свои водительские права.	ru
Estas ações são intransferíveis.	pt
Es ist nicht die physische Trennung von anderen Menschen, die uns einsam macht. Erst die geistige, die spirituelle Trennung führt uns in die Isolation.	de
ती त्याच्यापेक्षा जास्त हुशार आहे.	ma
We like reading English literature.	en
Я люблю поспать.	ru
Tom estas malrapida manĝanto.	ep
Waking up is the opposite of falling asleep.	en
Io non sono un gran nuotatore.	it
Abbiamo molta neve d'inverno.	it
Diga a Tom que estaremos prontos.	pt
Vi povus esti pli afabla rilate vian fraton.	ep
मंदीर टेकडीच्या टोकावर आहे.	ma
Er ist praktisch schon tot.	de
Дори и никой да не дойде с мене, ще отида да гледам този филм при всички случаи.	bg
Come back here. It's a trap.	en
Ozawa had not eaten anything since morning, or rather since the previous night.	en
Gehe sofort in die Universität, denn dort wird eine wichtige Veranstaltung stattfinden.	de
Она покрыла её лицо поцелуями.	ru
Tom l'ha fatto.	it
Meus antepassados foram os pioneiros desta terra.	pt
Ĉu vi scias kun certeco la prezon de tiu aŭto?	ep
I suggest you keep your voices down.	en
Pour réussir, il te faut admettre les opinions d'autrui et voir les choses à sa façon.	fr
"Birdo" estas la vorto.	ep
Mia frato aĝas du jarojn pli ol mi, sed li longas tri centimetrojn malpli.	ep
Mi simple volas feriojn.	ep
Tom lost his new watch.	en
La plupart des japonais boivent l'eau du robinet.	fr
In tal contesto non vengono considerati matti.	it
Penso che oggi farà caldo.	it
Cadendo, ha tirato il freno d'emergenza.	it
What does it matter to us?	en
Fra poco vai al gabbio anche tu?	it
Keskustelut kestävät kolme päivää.	fi
Er steckt das Messer neben die Scheide.	de
Le prove erano contro di me.	it
È competente?	it
Io non aiuto i poveri.	it
Massereiche Sterne sind äußerst heiß.	de
Deve asciugare i suoi vestiti in ogni caso.	it
No tienes que agradecernos.	es
Tom didn't tell anyone what he was about to do.	en
Ha messo su peso?	it
Das Verhalten der Dame war stets würdevoll.	de
This isn't the time or the place.	en
Tom ist ein netter Mensch. Alle lieben ihn.	de
O adam tuhaf birine benziyor.	tr
Havaalanına yakın bir otelde kalmak istiyorum.	tr
Ni eniris diablan cirklon.	ep
Tom nie chciał mi wierzyć.	pl
О, я и не знал.	ru
Tom realized that his father could no longer recognize him as his son.	en
Hiç tanımlanamayan uçan nesne gördün mü?	tr
Boston'a uçak bileti için ödeme yapmak zorunda değildim.	tr
Me desfiz dos sapatos.	pt
A diákok csendben ülve hallgatták az előadást.	hu
Ona söylemeye gitmek zorundayım.	tr
Sen bile onu hatırlıyor musun?	tr
Li estas efektive lerta.	ep
Tom lebt schon seit seiner Kindheit in New York.	de
Tom weiß genau, wie du dich fühlst.	de
Есть лишь один верный ответ.	ru
Ме изненади тоа што Том не ми се заблагодари за подарокот.	mk
Ми заповеда да ја напуштам собата веднаш.	mk
Mi ne ŝatas, ke oni moku min.	ep
Не беше лесно да се реши овој проблем.	mk
Io affilo i coltelli.	it
Most is sokáig kellett várnunk.	hu
La materialo estas plasta ankaŭ ĉe malalta temperaturo.	ep
Ве молиме ставете ги рацете зад грб.	mk
Nem tudhatom, hogy mire gondolsz.	hu
Вот как ты платишь мне за мою доброту?	ru
Vennünk kellett volna még egy üveg bort.	hu
All you have to do is write a few sentences about what you did yesterday.	en
Hastanın artık bir nabız atışı yok.	tr
Asansörle zemin kata indik.	tr
Dit is eenvoudig.	nl
Лично я думаю, что ты прав.	ru
บอกหล่อนว่าฉันจะโทรกลับไปทีหลัง	th
He tried again.	en
I should be back in two to three weeks.	en
Те покани ли Том на љубовна средба?	mk
Io non posso venire perché sono a Londra.	it
Језиво беше.	mk
O, Boston'dayken Tom'un ileri sınıflarından birine öğretmenlik yapacağım.	tr
Nyalakan radionya.	in
Нам бы не помешала твоя помощь.	ru
Как давно ты носишь контактные линзы?	ru
Vivian Ward geeft enkele Rodeo Drive verkoopsters een koekje van eigen deeg in de film Pretty Woman.	nl
Those men are strange.	en
Voi sentite quel suono?	it
L'as-tu embrassée ?	fr
Мы зашли пожелать тебе удачи.	ru
Geçen sene saçları uzundu.	tr
Kérlek, próbálj ki egyet!	hu
Хотите, я скажу правду?	ru
Tom'la gitmek istemediğine emin misin?	tr
J'étais sceptique.	fr
Tom istediğine sahip.	tr
Hayır!	tr
Ты что, не видишь, что я занят?	ru
Onu yapanın Tom olduğunu düşünüyor musun?	tr
Tom'un onu yapmasına izin verilmeyecek.	tr
Tom hat mehr Alkohol als Essen in seinem Kühlschrank.	de
Tom adında bir adam için çalışıyordum.	tr
Tomo volis, ke Mary ludu la violonon.	ep
Io sono attratto da te.	it
You can't be young.	en
Ovviamente non è giusto!	it
Düşman daha fazla direnç göstermeden pes etti.	tr
Ben bir banka personeliyim.	tr
Quando uma mulher finge não perceber alguma coisa é porque ela já viu o suficiente.	pt
Yo estoy suscrito a dos periódicos.	es
Откуда всё это взялось?	ru
Por que vocês sempre estão ocupadas?	pt
Se não fosse pelos livros, cada geração teria que redescobrir sozinha os fatos do passado.	pt
Combien de temps avez-vous vécu sur cette île?	fr
Tomo perdas la sinregon.	ep
Se på det tårn som står på bakken.	dk
Том всегда меня смешил.	ru
¡Contestadme!	es
Майк очень хорошо плавает.	ru
Bu gerçekten haksız.	tr
Qualcosa li ha spaventati.	it
Ce garçon est joueur, et je ne sais ce qu'il aime le mieux des femmes ou du vin.	fr
O seu amigo está na outra sala.	pt
Non li ho ancora chiamati.	it
Era para isto ser engraçado?	pt
Mi absolute certe scias tion.	ep
Tomo ne tiel dikas, kiel mi.	ep
Vi devas vidi ĝin por kredi ĝin.	ep
Tom sapeva che mancava qualcosa.	it
Sono sicuro che vi piaceranno.	it
Mia patrino ne tre bone scipovas la anglan.	ep
Нам нужно будет подождать пару часов.	ru
Perché avete firmato la confessione?	it
Какой хлеб ты ешь?	ru
Tomo boligas ovon.	ep
I don't study.	en
Bavullar nerede?	tr
Tom will up sticks at his aunt's house; he thinks he may be a burden to her.	en
Tomo vundis al si la genuon, kiam li falis.	ep
Ogni volta che le sigarette salgono di prezzo, molte persone cercano di smettere di fumare.	it
Sur la truo de la nun varmega hejtilo oni ŝovis la vaflilon kun ĝia nigra ringo.	ep
Том не боится умереть.	ru
Eu sou uma pessoa estressada.	pt
Distinguiamo il vero dal falso!	it
Banyo yapıyorlardı.	tr
Li ŝatis skiadi tiom ofte, kiom li deziris.	ep
Osztok-szorzok, de egyszerűen nem tudom, miből fogjuk kifizetni az adósságainkat.	hu
A bort a pincéjükben tartják.	hu
Das Leben ist ein Spiel auf einer Bühne, das unsere Aktionen bringt, uns wechselweise zum Statisten, Publikum oder Hauptdarsteller macht.	de
То, что происходит с экологией в нашей стране, — это просто национальный позор.	ru
Tom foi o primeiro a perceber o que estava acontecendo.	pt
I like your writing style.	en
Mi faris nenion dum mia feritago.	ep
Le produit national brut est la somme de la production totale de biens et de services en valeur financière.	fr
Je vais lui demander où il est allé dimanche dernier.	fr
Beware! There's a car coming!	en
Bring me two pieces of chalk.	en
What is the main industry in this town?	en
Le Japon a une densité de population élevée.	fr
Op onze website, http://www.example.com, staat alle informatie die je nodig hebt.	nl
The party was all but over when I arrived.	en
He was reading a textbook on American history.	en
He did not know what to say.	en
He had to lead a miserable life for many years.	en
He is the greatest statesman that ever lived.	en
Tears fell from her eyes.	en
She had no choice but to accept her fate.	en
She is like a mother to me.	en
My mother is busy planting flowers in the garden.	en
I am no more happy than you are.	en
If it rains tomorrow, I will stay at home all day.	en
Penses-tu qu'il est bien pour la place ?	fr
Prawda nie potrzebuje wielu słów.	pl
Nie jest już taki jak kiedyś.	pl
On jest niewysoki, podobnie jak ja.	pl
Le cicale stanno cantando.	it
Завтра воскресенье.	ru
Hei Mimi! Mitä kuuluu?	fi
До свидания, до завтра.	ru
Ha un'auto straniera.	it
Ho già visto il film.	it
Kijk naar hem en doe wat hij doet.	nl
Gisteren kocht ik een boek.	nl
He tried to get me to help him.	en
Il était le premier à arriver.	fr
John gitarludis kaj liaj amikoj kantis.	ep
Kia maljuna li estas!	ep
Ŝi volas ĉeesti la feston.	ep
Lia romano estis tradukita en la japanan.	ep
No, non troppo.	it
Quand'è arrivato il suo treno a Kyoto?	it
Algunos niños están nadando en el río.	es
Я нашёл яблоко и съел его.	ru
Perdí a mi esposa el año pasado.	es
Faðir, eignast fé fé? Nei, fé eignast lömb.	is
John er ekki sami maður og hann var fyrir þremur árum.	is
要是你注意你的外国朋友，可能会对他们跟你不一样的传统和习惯感到惊讶。	zh
Nie mogę dać ci się lenić. Musisz podjąć konkretną pracę.	pl
Il va faire assez froid.	fr
Lass dich durch nichts daran hindern, Erfolg zu haben.	de
Mi faligis arbon.	ep
Боюсь, что после обеда пойдёт дождь.	ru
Entre nous, il est plutôt stupide.	fr
Het is mijn doel om altijd de beste oplossingen te vinden.	nl
Die Fragen dieser Klausur stammen vorwiegend aus den Bereichen Morphologie und Syntax.	de
Walking is a healthy form of exercise.	en
Sind Sie ein wandelndes Wörterbuch?	de
Almost all dogs are alive.	en
Olíuflutningaskip er skip sem flytur olíu.	is
Fui a Osaka a visitar a mi amigo enfermo.	es
Ele não gosta do diretor.	pt
Gosto de dormir numa cama macia.	pt
Ele está desanimado pelo fracasso no exame.	pt
You should avoid tight fitting clothes if you are pregnant.	en
Ĉu vi estas religiano?	ep
El punto al que quería llegar es que nos iría mejor si aceptara el ascenso.	es
Se vai in autobus, puoi arrivarci in circa un terzo del tempo.	it
Tom was sentenced to death.	en
Tom kept me waiting for more than 30 minutes.	en
Tom felt happy.	en
Washing the car took longer than we expected.	en
Ekspedu vin for!	ep
En la pasinta jaro mi loĝis en Nov-Jorko.	ep
Questo è un altro problema.	it
Su valentía será recordada.	es
Ich weiß nicht ob ich da mit dir einer Meinung bin.	de
Il Tanakh è la Bibbia ebraica.	it
Sinjoro Berg helpas vin.	ep
Siglo dieciocho, a menos que sea una falsificación.	es
Es imponiert mir, wie du dich gegen Widerstände durchsetzt.	de
La ambulanco perdis la stireblon kaj preskaŭ surveturis piediranton.	ep
Prenez un bus.	fr
Es hora de dar de comer a las ovejas.	es
El volcán entra en erupción a intervalos regulares.	es
Mój tata gra w tenisa każdej niedzieli.	pl
Ich habe erfahren, dass er morgen abreist.	de
Acı biraz azaldı.	tr
La neĝoŝtormo daŭris.	ep
Tom perdió contacto con Mary.	es
Ce travail n'est pas un jeu d'enfant.	fr
Lui è un uomo di cui ci possiamo fidare.	it
Буря повалила дерево.	ua
Él dijo mi nombre.	es
Disseram que ele era um oriental falante e barulhento.	pt
Mi ofte pensas pri ili.	ep
Fico feliz que Tom tenha conseguido mudar de nome.	pt
Te escribo una carta extensa porque no tengo tiempo de escribirte una breve.	es
Sie spionierten ihm nach, während er badete.	de
¿Alguna vez has tomado unas vacaciones?	es
Die Sprache kann einem wie ein bodenloses Meer vorkommen, ohne andere Grenzen als den Horizont.	de
Kalp yetmezliğinden aniden öldü.	tr
Du liegst trotzdem falsch.	de
Ich habe einen Schatz gefunden.	de
E se vocês estiverem erradas?	pt
Das ist ein Brief aus Kanada.	de
Elle sera toujours parmi vous.	fr
Tom ist faul.	de
Ŝi estis akceptita en la universitato de Waseda.	ep
Ich weiß nicht mehr, warum ich das getan habe.	de
Let's not overdo it.	en
Ne estas tiel, ke mi ne volas fari ĝin.	ep
I don't want to tell Tom I've been to Boston.	en
El papel vegetal es muy económico.	es
He loves soccer.	en
El susurro del arroyo me dio sueño.	es
Kahve çok şekerli.	tr
Köpenhamn är Danmarks huvudstad.	se
Liisa scheut die Öffentlichkeit.	de
Halte jeden für einen Engel und schließe die Sachen vor ihm wie vor einem Diebe.	de
De verdad te amo mucho más que a ella.	es
Ich habe geerntet.	de
I'm for that.	en
Hay que meter en cintura a ese chico.	es
¿A dónde va ese camino?	es
त्याने मला वचन दिलं.	ma
Tio ne respondas mian demandon.	ep
Tom and Mary don't need a chaperone.	en
Das ist nur zum internen Gebrauch bestimmt.	de
Er wurde traurig, als er es erfuhr.	de
Mutassa az útlevelét.	hu
Tom doesn't like to get his hands dirty.	en
Stiamo perdendo tempo.	it
Dein Plan ist gescheitert.	de
Эта площадь когда-то считалась самой оживленной площадью Европы.	ru
Sanırım Tom uykuda.	tr
Voy a poner un apósito.	es
Madem onu seviyorsun, neden ona destek olmuyorsun?	tr
Том - мой адвокат.	ru
Является ли мой ответ верным?	ru
Die neue Schule hatte es versäumt, die besonderen Bedürfnisse junger Menschen zu berücksichtigen.	de
Ballerò con Tom.	it
Я сделаю это один.	ru
Кто-то звонит в звонок, но я никого не жду этим утром.	ru
Tom won't be able to get up that early.	en
You must be sleepy.	en
Ich hatte mit ihnen nichts gemein.	de
Tässä on vain yksi ongelma.	fi
Эта кукла была подарком от моей тёти.	ru
Minun oli saatava jotain autosta.	fi
Estante vera "marurso", li sur firma tero ĉiam sopiras senti la tabulojn de ferdeko sub siaj piedoj.	ep
I should've never let Tom go swimming by himself.	en
मी माझे काही जुने कपडे सॅल्व्हेशन आर्मीला देऊन टाकले.	ma
Bence çok memnun kalacaksınız.	tr
Du warst für Tom da, wenn er dich brauchte.	de
Я опоздаю.	ru
Avrete il diritto di scegliere.	it
Tocca a me provare a risolvere il problema.	it
Perché i momenti di pura gioia devono essere sempre interrotti da momenti di rabbia e sconforto?	it
È impazzito per via dello shock.	it
Ĉu vi scias, kio estas tio?	ep
Ils ont été ici à partir de cinq heures.	fr
It's moving fast.	en
Tom is always quoting some famous person.	en
Ils sont cousins au second degré.	fr
Vede tutto in termini di denaro.	it
Мы все знаем, как это может быть опасно.	ru
Nel parlato si usa spesso il discorso diretto per riportare altri discorsi.	it
Non riesco a immaginare la vita senza Tom.	it
Tom, powiedz coś.	pl
আমাদের খালি টমকে আমাদের হয়ে এই কাজটা করে দিতে বলতে হবে, তাই না?	bj
Prices have risen quite a lot in the past few years.	en
Zaten aptalca bir fikirdi.	tr
Toda la clase debe aprenderse el poema de memoria.	es
Go tell that to Tom.	en
Tom hasn't even told Mary his name yet.	en
Kuka on lempinäyttelijäsi?	fi
Warum hassen alle Tom?	de
I hadn't expected us to speak so much about love this Monday morning.	en
Giuro che poi la smetto.	it
Yeni yönetim altındayız.	tr
Том собирается купить новый компьютер.	ru
Ты должен мне пиво.	ru
Il est interdit de fumer dans une voiture avec un enfant de moins de 16 ans.	fr
Call Tom, but don't tell him what really happened. Tell him it was an accident.	en
La signification des phrases est altérée lorsque la ponctuation est modifiée.	fr
La smetta di seguire Tom.	it
Es braucht an diesem Text nur Weniges verändert zu werden.	de
Aynı anda iki insanı seviyorsan, ikinciyi seç çünkü birinciyi sevseydin ikinciye tutulmazdın zaten.	tr
On Sunday we put the clock forward.	en
Eve geldiğim zaman, paspasın üzerinde tökezledim.	tr
Все высоко оценивают её работу.	ru
Está bem agora?	pt
Tom'a ne yapmak istediğini sordum.	tr
Tom ailesinin evinden taşındı.	tr
This is highly unusual.	en
Nessuno riusciva a far ridere la principessa.	it
La escuela empieza a las nueve y acaba a las seis.	es
এই রাস্তাটার নাম কী?	bj
Том сказал, что спешит.	ru
Tom puhuu ranskaa hyvin.	fi
È restata a casa.	it
Lind on taevas.	ee
Tom é menor de idade.	pt
Ben çok, çok mutlu bir adamım.	tr
Tom was celebrating the victory with wine.	en
Mi cola il naso.	it
Néhány nyugtalanító hírt hallottam ott.	hu
Io accettai l'offerta.	it
Люди раньше думали, что Солнце вращается вокруг Земли.	ru
Jaj de szépen süt az őszi napsugár.	hu
Sən hər şeyi Toma deməməlisən.	az
Кое го претпочиташ?	mk
Ili longe kaj multe parolis unu kun la dua.	ep
Mitől vagy úgy meglepve?	hu
He went to Ashkhabad.	en
Секоја вечер одам на прошетка со маж ми.	mk
Тоа не постои во природата.	mk
Том и Мери зборуваа за војната.	mk
Tom 2.30'dan önce onu yaptırmak için çok çalışıyor.	tr
Hei! Tiedätkö, että tänään on minun syntymäpäiväni?	fi
Вы можете сделать это потом.	ru
A gyár televíziókat állít elő.	hu
Här är lite vatten.	se
Man merkt, dass es dir gefallen hat.	de
Nem érinthetlek meg?	hu
Он не доверяет полицейским.	ru
Wie würdest du reagieren, wenn deine Frau so etwas zu dir sagen würde?	de
The river flows in front of our village.	en
Siete preoccupate per il riscaldamento globale?	it
Karomba zárlak majd egy éjszakán.	hu
25 yaşına gelinceye kadar beş farklı ülkede yaşadı.	tr
Jetzt wird das langsam ein bisschen albern.	de
Existent-ils ?	fr
Sok munka van még.	hu
Tom sırlardan nefret ediyor.	tr
Kim olduğunuzu biliyor musunuz?	tr
Расскажи мне о них побольше.	ru
Tom a szomszéd faluban él.	hu
Том трижды спасал мне жизнь.	ru
Лицо Тома стремительно побагровело.	ru
Эти розы цветут весной.	ru
Le ho detto di non lasciare andare la corda, però è quello che ha fatto.	it
Ők nem beszélnek angolul.	hu
Ты застрял?	ru
Я знаю, что вы ненавидите свою работу.	ru
Meg fogod tartani az ígéreted?	hu
U hebt een ziekenwagen nodig.	nl
Umut kayıp değildir.	tr
Fojfoje vi timigas min.	ep
Doktorum sigara içmeyi bırakmamı söyledi.	tr
E te ne accorgi solo adesso?	it
Tämä planeetta kiertää kahta tähteä.	fi
Voi avete delle disabilità?	it
Том казался сердитым.	ru
Mi decidis ne plu surmeti subvestaĵojn.	ep
Por favor, deixe livre a tarde do próximo sábado.	pt
La knabino estas fototaŭga!	ep
Kiel eblas, ke vi vidis ilin, dum ili faris tion?	ep
Vi bezonas scii, kion mi opinias.	ep
Dovremmo dirle la verità.	it
Io sono un eiaculatore precoce.	it
Я закрывал магазин.	ru
Hol szomj honolt, ott okos bolond kolompot lopott s bort hozott, hogy torkon folyjon.	hu
Этот воробей не может летать. У него сломаны крылья.	ru
Io non ho mai avuto l'occasione di incontrarle.	it
Meg volt az egyedüli csajszi, aki farmerbe feszített.	hu
Bedankt voor uw moeite.	nl
Ĉu mi atribuis al vi la sidlokojn?	ep
L'imputato non ha precedenti di abuso di droghe.	it
Эта кровать кажется прочной.	ru
Eve yürürüm.	tr
Tom voleva qualcosa di freddo da bere.	it
Tom arriva à l'hôtel.	fr
Tom a dit à Mary de ne pas nager avec John.	fr
Je n'ai aucune idée de qui il est.	fr
I was very pleased.	en
Mississippi'nin en alçak noktası nedir?	tr
Tom eğlendiğini söylüyor.	tr
Lei non è di queste parti, vero?	it
Tom ha fatto a Mary un massaggio ai piedi.	it
Tom'un uzun kahverengi saçı var.	tr
Tomo ĉiam pensas pri manĝaĵoj.	ep
Ĉu mi povas ŝalti la radion?	ep
Вы обещали!	ru
Io sarò occupato questo pomeriggio.	it
Voglio incontrarti.	it
Me l'avete donata.	it
Зачем ты идёшь?	ru
Le meilleur moyen pour apprendre à se connaître, c'est de chercher à comprendre autrui.	fr
Я бы очень хотел пойти, но не могу.	ru
Сходите в магазин.	ru
Non sono molto brava.	it
Io sono imparentata con lui.	it
Tom eats lunch in the school cafeteria.	en
Les conducteurs devraient toujours être sur leur garde quant aux accidents.	fr
As far as I know, he is American.	en
The little boat bobbed on the rough sea.	en
Nobody that has any common sense would think of doing such nonsense.	en
In old times people didn't think that the earth is round.	en
He managed to avoid damaging my reputation by dropping a hint.	en
He shut the door behind him.	en
His quick temper will get him in trouble one day.	en
He has done many things for poor people.	en
Japón es un país agraciado.	es
Lo discutimos agradablemente tomando una copa.	es
Na razie są mali, ale wkrótce otworzą sklep w twojej okolicy.	pl
Welche Absicht verfolgst du damit, Englisch zu lernen?	de
We are not human beings having a spiritual experience; we are spiritual beings having a human experience.	en
Эта сумка моя.	ru
Tiun birdospecion onidire minacas formorto.	ep
Не говори так.	ru
Eldri bróðir minn kláraði heimavinnuna sína mjög fljótt.	is
Uzağa gidiyorum.	tr
La prezoj altas.	ep
Mając czas, studiowałbym francuski.	pl
Le vi hace tres años.	es
Tio ĉi ne funkcias!	ep
Þess lags hlutir geta gerst þegar maður er að flýta sér.	is
Trabajo con un español.	es
Mi studas la italan ekde malmultaj monatoj.	ep
Oni batas la oron, por provi ĝian valoron.	ep
Kiu povas konkuri kun la beleco de la naturo?	ep
Wie is die vrouw?	nl
I apologize for what I said.	en
La tuta klaso ridaĉis pri la malbona lernanto.	ep
Mi intencas viziti vin iam ajn baldaŭ.	ep
Er verlief sich in der Stadt.	de
Nie jesteś wobec niej szczery.	pl
La malvarmo malutilas al la rozoj.	ep
Su comportamiento me molestó.	es
Влюбен съм в нея.	bg
Тя е богата жена.	bg
Aren’t they going to the ceilidh in the town?	en
Ich würde dies bitte gern versichern.	de
切記！	zh
Estoy orgulloso de vosotros.	es
Lamentamos sua morte.	pt
Mi aĉetos tiun skribotablon por li.	ep
Tom had nothing more to add.	en
Manga " One Piece " Malezya çok popüler.	tr
Magnalena e Ania são boas amigas.	pt
Tom kitabı bir kenara koydu ve yukarı baktı.	tr
Some people like the sea more, others like the mountains more.	en
O futbolu sevmez.	tr
Tom acha que cerveja é bom para você.	pt
Sanoit hänelle, että olit lopettanut työn kolme päivää sitten.	fi
Tom kendini suçlu hissetti.	tr
Tom söyleyecek doğru kelimeleri düşünemedi.	tr
Mi vidis la aspekton de viro.	ep
Das weiß er selbst am besten.	de
Benim için kamerama sahip çık.	tr
Kuvvetli bir rüzgar vardı.	tr
Egyes emberek gyűlölnek vitatkozni.	hu
Je ne me coupe jamais les ongles la nuit.	fr
Tio ne ekzistas.	ep
Du solltest immer deine Hände sauberhalten.	de
Mi tío tiene una casa en Italia.	es
Miért vagy ilyen búval bélelt?	hu
Jen listo de ligiloj al esperantolingvaj retpaĝoj.	ep
Ce chemin est très long.	fr
Où as-tu été durant tout ce temps ?	fr
Je ne comprends pas pourquoi elle éprouve des réticences envers l'éjaculation faciale.	fr
Se habla ruso.	es
Un virus infectó el computador de Tom.	es
Да, я очень люблю готовить... и поесть.	ru
Tom wohnt in einem ruhigen Stadviertel.	de
Я сознался в краже денег.	ru
Legfőbb ideje megházasodnod és letelepülnöd.	hu
Sorunuzu anlamıyorum.	tr
Die chemische Formel von Wasser ist H₂O.	de
Tiu virino malprave akuzis min.	ep
Warum sollte ich nicht altern? Ich habe es mir durch meine Jahre verdient.	de
Onunla ilk karşılaştığımda otuzuna yaklaşıyordu.	tr
Un anuncio seductor para un centro vacacional de verano.	es
Tom Mary'ye gerçeği söylemeliydi.	tr
Gelmemesini söyleseniz bile, gelir.	tr
То, что не убивает нас, делает нас сильнее.	ru
Wer Packungen öffnet, muss sie kaufen.	de
Il gatto cominciò ad addentare il topo che aveva catturato.	it
Tom is in the other room drinking vodka.	en
Ils font une pizza délicieuse.	fr
J'attendais mieux de lui.	fr
Dehors la lueur s'accrut.	fr
George Bush estas la kvardek-unua prezidanto de la Usono.	ep
我想跳舞。	zh
Mi diras softe softe: "Timas mi."	ep
Ne sais-tu pas combien il est dangereux d'aller nager seul ?	fr
The human soul is built such that a lie works upon it a hundred times better than the truth does.	en
Tom aiguisait les couteaux.	fr
Tutti i suoi parenti sono in Siria.	it
Ah! Se fossi ricca, mi comprerei una casa in Spagna.	it
I couldn't stop myself from laughing.	en
I miss him a lot.	en
C'est très drôle.	fr
Would you please leave us alone for a minute?	en
È una storia molto triste.	it
Wie kann das Internet zur Förderung der Wissenschaften beitragen?	de
Haga el favor de bañar a los niños.	es
I could make you something to eat.	en
I couldn't help but notice that you're in pain.	en
Името му е познато на всички.	bg
Sie verbrachten drei Jahre im Gefängnis.	de
J'aime que les choses soient faites correctement.	fr
谁帮帮她？	zh
La future mariée a réalisé, le matin de son mariage, que sa robe de mariée ne lui allait plus.	fr
O aslında gerçekten eğlenceliydi.	tr
Он попытался рано встать.	ru
Ben de faydalı olmak istiyorum.	tr
Tem uma passagem secreta à esquerda.	pt
Mi ne tagmanĝos, mi sekvas dieton.	ep
Wouldn't that be neat?	en
Mi volas mortigi min.	ep
Ellos van de compras.	es
Eres una chica hermosa.	es
Bence Tom çok hasta.	tr
Voi, kuljettaja on kahjo.	fi
Kion vi komencis, vi sen dubemo alfinigu!	ep
Lui ha abbandonato la sua famiglia ed è andato a vivere a Tahiti.	it
Ben şu anda gelemem.	tr
They are wasting time.	en
Karımı terk ettim.	tr
¿Tom es tu sobrino?	es
Ça n'est pas un jeu.	fr
La urbo havas mirindan lokon por promenoj kun infanoj.	ep
"Ne oldu?" "Benim bilgisayar çöktü."	tr
Tom said he couldn't find a job.	en
Per quanto tempo sei rimasta a Caracas?	it
Ĉu vi ne konscias, ke via konduto metas nin ĉiujn en malbona lumo?	ep
Mi sentis min timigita.	ep
У Тома высокое давление.	ru
Tengo evidencia.	es
Tomo agas, kvazaŭ nenio estus okazinta.	ep
Mi kredas danĝere, ke vi transiras la riveron.	ep
What happens if Tom loses?	en
Mi studis dum kelka tempo posttagmeze.	ep
Tomo ne sukcesis eltordi de Manjo ŝian sekreton.	ep
Si è lanciato.	it
Hän on tottunut valvomaan myöhään yöhön.	fi
Mi ne disponas la opcion.	ep
Possiamo dormire serene!	it
Mia avo ne bone aŭdas pro sia aĝo.	ep
Il va pleuvoir toute la nuit.	fr
Sue kirjautui sisään Royal Hotelliin.	fi
Non ci si può fidare dei sondaggi.	it
Mais au fait, d'où venez-vous ?	fr
Ich möchte bei dir sein, wann immer es möglich ist.	de
Ha già perso tutti i capelli.	it
Sizinle yollarımız ayrılıyor ve bunun müsebbibi ben değilim.	tr
Quanti studenti ci sono nella scuola?	it
Нет, я не помню. Я ещё не родился.	ru
Ili ambaŭ estis ebriaj.	ep
La juna politikisto postulas forigi ĉiujn impostrabatojn.	ep
Mary'e aşık olduğumu unutma.	tr
Tio estas lukto inter du fortoj, kiuj ambaŭ estas necesaj por la evoluo.	ep
Ci aspettavamo che Takahashi si ubriacasse e dicesse alcune cose strane, ma ha finito per non bere troppo, quindi non era interessante.	it
The picture that you hung up yesterday afternoon fell down this morning.	en
Io non ho mangiato altro che pane e burro.	it
Где твой кошелёк?	ru
Я была единственной, кто не знал.	ru
Je ne sais pas ce que tu as entendu dire à mon sujet.	fr
Я тебя ослушался.	ru
Kian domon vi havas?	ep
Tom wanted Mary to go to the supermarket to buy some milk.	en
Tom must've known about it already.	en
Tom dün gece huysuzdu.	tr
Bay Bean çok komik!	tr
Hat Tom gesagt, worum es bei dem Meeting gehen würde?	de
I knew Tom would be thirsty.	en
Я обещал сходить.	ru
Tom ist der Einzige, der dir dabei helfen kann.	de
Bu gece akşam yemeği için balık yiyeceğiz.	tr
Tom ofis binasının önünde bir resim için poz verdi.	tr
Vi ne kalkulu je ŝi, ĉar ŝi estas tro nerespondeca.	ep
Hasta las dos y media de mañana tendrás tiempo para terminar esto.	es
Mənə üç ay ver.	az
This is a private meeting.	en
Well, that's what you want, isn't it?	en
Revenu en vian aŭton.	ep
Onları göreceğim.	tr
Mancher Schüler übertrifft den Meister.	de
Том не се насмеа на ниедна од смешките на Мери.	mk
Имаш ли лек против кашлица?	mk
Felavattuk az új hidat.	hu
Nə demək istədiyini başa düşmürəm.	az
Why do you want this job?	en
Ова е добра пригода да ја опљачкаме банката.	mk
Loro non affileranno i coltelli.	it
Том навистина сакаше да патува.	mk
Tomo vetis kun Manjo.	ep
Каде рече дека се случило тоа?	mk
Tomi lähti varoittamatta.	fi
Sicuramente ci sono meno tasse!	it
Vogliono solo i soldi.	it
Том нема пријатели со коишто може да разговара.	mk
Despite his being so tall, women find him quite attractive.	en
Wann hast du ihre Bekanntschaft gemacht?	de
Achète-moi ce livre, s'il te plaît.	fr
Том неправильно понял.	ru
Birçok çocuk bağırıyor, bu can sıkıcı bir durum.	tr
Es dos años menor que yo.	es
I'd appreciate it if you did that for me.	en
It all happened quickly.	en
We really appreciated everyone's help.	en
Они бы не поняли.	ru
Tiu estas ŝia dua filo.	ep
Brezilya iklimini severim.	tr
Hoe laat moet ik vertrekken?	nl
Un enfant est manquant.	fr
Tom, bir arkadaşımın arkadaşının arkadaşı.	tr
I bought Tom a laptop.	en
Bu oldukça aşırı.	tr
O, tarlasına buğday ekti.	tr
У нас будет много еды.	ru
Ich räumte mein Zimmer auf.	de
Prezidento ĜEKSON ne konsentis.	ep
Deve dirle la verità.	it
Li nepre venos.	ep
You shouldn't drink this water.	en
En ĉiu familio ekzistas sekretoj.	ep
Мы учитываем также и человеческий фактор.	ru
Şu anda onunla ilgileniyoruz.	tr
Mandolinler sebze dilimleme için uygundur.	tr
Tout n'était pas de ma faute.	fr
Том повернул направо, когда надо было повернуть налево.	ru
Bush respektas ĉiujn religiojn.	ep
Saĝulo faras komence, kion malsaĝulo faras en la fino.	ep
Lui si avvicinò alla porta.	it
Sınıf arkadaşlarımın bazıları yeni internet kullanıcısıdır; onlar bilgisayar bilimleri hakkında hiçbir şey bilmiyorlar.	tr
Tomi egy baleset következtében elvesztette egyik szeme világát?	hu
A me piace davvero la tua musica.	it
Lo so che aveva paura.	it
Ili helpis unu la aliajn.	ep
Том с Мэри поженились уже через три месяца после того, как познакомились.	ru
Обе ушли.	ru
Noi siamo molto fieri di voi.	it
This time is no different.	en
Terapi toplantı halinde.	tr
Let's see what can be done.	en
Mi estas humila.	ep
Ich belle wie ein Hund.	de
Bizim birçok şeyi tartışmamız gerekiyor.	tr
Keşke nasıl tenis oynayacağımı bilsem.	tr
Mi ne plu povas toleri vian konduton.	ep
Вы идёте гулять?	ru
टँपॉन कुठे आहेत?	ma
Os britânicos resmungões se foram de vez. Deus abençoe a União Europeia, que, como resultado disso, vai ficar mais forte.	pt
A gata está comendo.	pt
Die Waldelfe verwandelte Toms gezücktes Schwert in einen Schwarm von Schmetterlingen.	de
Никто не знает, как она работает.	ru
Строит из себя невесть что!	ru
Als biologisches Wesen gehört der Mensch zur Tierwelt.	de
Das machte mich wirklich traurig.	de
Tom era morto.	it
You have to fill out this form.	en
Tom wohnt am Stadtrand.	de
Hombre precavido vale por dos.	es
Yo solo sé leer las etiquetas.	es
La vieille quitta le bus.	fr
Ni havis la saman ideon.	ep
Tiam paĉjo aperis tutvestita.	ep
Kiu estas la plej bona solvo?	ep
Hepimiz geçmek istiyoruz.	tr
Ŝi plej ofte devas cedi al sia granda fratino.	ep
Ĝi estis malriglita.	ep
Tom mi sta insegnando a nuotare.	it
Não quero vê-la nunca mais.	pt
Я ободрал колено.	ru
Tom criticizes everything.	en
Li aŭdis la novaĵon trankvile.	ep
Je sais où tu gardes ton arme.	fr
Нам всего один нужен.	ru
Tom ma długą brodę.	pl
The man was immediately arrested.	en
Die Jacksons verschwanden einfach.	de
That was very well executed.	en
Ти, мабуть, голодна.	ua
Мэри грациозно сделала книксен.	ru
Quiero emigrar a Australia.	es
Ich stimme mit Tom in so gut wie nichts überein.	de
J'avais un grand appétit.	fr
Can you share food with others in the face of famine?	en
Are you going to take part in the English speech contest?	en
Hard work has brought him success.	en
It seems to be a good house.	en
Somebody told me that today's test was identical to the one we had last year.	en
My sister is cooking in the kitchen.	en
My opinion is somewhat conservative.	en
My sister likes classical music no less than I do.	en
I know him to be honest.	en
I have a suspicion about his death.	en
Am I fully covered in case of an accident?	en
The soap hurt my eyes.	en
Je me demande ce que je devrais faire aujourd'hui.	fr
我看见远处有灯光。	zh
Калі я ішоў па вуліцы, я сустрэў старога сябра.	be
What do you do for a living?	en
Por esti sincera, mi ne amas lin.	ep
He nukahtivat elokuvan jälkeen.	fi
Li estis tiel afabla nin transporti al la insulo per sia boato.	ep
Ce problème est trop simple.	fr
Un androïde est une sorte de robot.	fr
Mi donis al li bildstrion por legi.	ep
Ŝi min demandis, ĉu mi eble ne bone fartas.	ep
Pro sia doloro ŝi ekploris.	ep
Hai qualche matita?	it
Savjest grize bez zuba.	hr
Hij is een scherpschutter.	nl
Ora che hai raggiunto l'età hai il diritto di voto.	it
Védekeznünk kell a közlekedési balesetek ellen.	hu
Su oferta es muy tentadora, pero tendremos que pensárnoslo.	es
Ik was dat van een betrouwbare bron te weten gekomen.	nl
My neighbor is a penny-pinching old miser who won't even give you the time of day.	en
“你怎么来了？”他惊讶地问我。	zh
Nunca he oído hablar de esa ciudad.	es
Arabía er rík af olíu.	is
Leteroj estas liverataj ĉiutage.	ep
Mój wuj, który mieszka w Osace, wczoraj przyjechał nas odwiedzić.	pl
Lis-la encore une fois, je te prie.	fr
I have read the book.	en
I think it's time for me to ask for her help.	en
Sie wollte nicht, dass er noch länger bleibt.	de
Son séjour d'un an en Allemagne fut très fructueux.	fr
Kann ich ein paar Käsebrote haben?	de
Pode ser que a China seja a grande potência do futuro.	pt
Romo estas itala urbo.	ep
Voici le cortège de journalistes dont je vous ai parlé.	fr
Az vesse rám az első követ, aki ártatlan.	hu
Ao voltar de férias, a primeira coisa que fizeram ao entrar na casa foi ligar a água e a luz.	pt
Comment est-ce que je déclare un vol ?	fr
Además de hacer el amor y leer a Flaubert, no hay nada más agradable que hacer traducciones en Tatoeba.	es
Tom makes up stories all the time.	en
Ты проверил, что дверь крепко закрыта?	ru
Tengo una gran colección de estampillas.	es
Ele disse isso mesmo?	pt
Que vous êtes drôle.	fr
Que festa alegre a de hoje!	pt
Envenu, ekstere estas malvarme.	ep
Jen ĉiela interrilato de amemaj sentoj.	ep
La ĉefa parto de la laboro estis silente farita de ŝi.	ep
L'aria è pura qua intorno.	it
Der Erlös der Tombola kommt wohltätigen Zwecken zugute.	de
Tiu ĉi ludo estas riska.	ep
O hep meşgul.	tr
Esti vidalvide kun dinosaŭro estis amuza sperto.	ep
Tijdens een wandeling in het park kwam ze toevallig haar oude vriendin tegen.	nl
Mi forgesis vian adreson.	ep
If you may come home for Christmas? I don't know, I'll mention it to my wife and I'll tell you.	en
Ella le recogió en la estación.	es
Sein verschmitztes Lächeln verheißt nichts Gutes. Ich glaube, er führt etwas gegen uns im Schilde.	de
O, odada yalnız bırakıldı.	tr
Jag kommer att bli älskad.	se
Eşyanı geride bırakma.	tr
Non sono bravo a classificare le cose.	it
The research is finished?	en
Dies ist ein ganz milder Kaffee.	de
Pobiegliśmy za złodziejem.	pl
Il répare sa propre voiture.	fr
Hoy le confesé mi amor. Yo dije: "Me he enamorado de ti". Luego, al comienzo ella no supo qué decir. Pasaron unos minutos hasta que finalmente dijo: "Todo esto va demasiado rápido. Primero quiero conocerte mejor."	es
Je mil diabloj, kion vi faras ĉi tie?	ep
Je mehr du einnimmst, desto mehr kannst du ausgeben.	de
La pollution de l'air est une menace pour notre survie.	fr
Rüzgar kuzeyden esiyor.	tr
Lasciateli venire tutti.	it
Raftan bir kitap indirdi.	tr
Bu yasa 1918 yılında çıktı.	tr
Post enlitiĝo, fajro estu nenie, krom en supremenciitaj lokoj.	ep
Bir futbol takımı on bir kişiden oluşur.	tr
Tom sagte, dass er Maria aufgetragen habe, ihre Hausaufgaben zu erledigen.	de
La ceguera te aisla de las cosas. La sordera te aisla de las personas.	es
I told Tom you didn't have a wife.	en
Je ne les moule pas.	fr
Mi ne povas trovi mian vestosakon.	ep
Where are my clothes?	en
Se Dio kun ni, kiu kontraŭ ni?	ep
Я просто хочу быть его другом.	ru
Danke. Ich werde ihn also löschen.	de
Vous avez abattu un arbre.	fr
Nous sommes en lune de miel.	fr
Mi diccionario de español recomienda no usar la palabra "desgraciado" en Ecuador.	es
Marie pretos.	ep
Elle joue dans la catégorie au-dessus de la tienne.	fr
Wann wird die Beschneidungsfeier stattfinden?	de
Now keep calm.	en
Es weht ein kalter Wind.	de
Nous l'avons cuit ensemble.	fr
O doutor recomendou que você pare de fumar.	pt
Kion li faris tiam, kiam vi vidis lin?	ep
Li malfruis por la vespermanĝo.	ep
No se atrevía a dar un paso más, sabía que en cuanto cruzase la puerta no habría vuelta atrás.	es
Tu es inquiète, pas vrai ?	fr
Li estis en Francujo.	ep
¿Dónde cogiste este autobús?	es
Остров расположен к западу от Японии.	ru
Merak etme çok şey öğrendim ve size kızmıyorum.	tr
У меня тоже есть одна.	ru
You are excused.	en
आपल्याला टॉम सापडला आहे.	ma
Tom doesn't do anything without first asking Mary if it's OK.	en
तुम्ही कुठे काम करता मला माहीत नाहीये.	ma
Марсиане говорят по-английски?	ru
Non posso proteggerla qui.	it
Lavora pochi giorni alla settimana e guadagna poco denaro.	it
Non è lei stesso oggi.	it
Io voglio tenerla.	it
Starr doch nicht so!	de
Доктор пришел в последний момент.	ru
Я беру уроки танцев и моделирования.	ru
Geld, Geld, Geld? Geld schießt keine Tore! Fußball ist so einfach geblieben, wie er immer war: Es spielen elf gegen elf auf sechzig mal hundert Metern.	de
Wir haben die Gehälter um drei Prozent erhöht.	de
Los muertos vivientes se alimentan de carne humana.	es
Там вы найдете объяснения, которые точнее и надежнее чем те, которые я вам могу дать.	ru
Tom bizi gözetliyor.	tr
Tom beni saatini çalmakla suçladı.	tr
Copenhague, a capital dinamarquesa, é cortada por canais, embora não tão numerosos como em Amsterdam.	pt
Tom left us some things.	en
Ele concorda que nós venhamos.	pt
La moneta unica può essere un esempio di cooperazione rafforzata.	it
That's a big question.	en
Niets kan haar nog tegenhouden om met hem te trouwen.	nl
Ero una delle studentesse migliori della classe.	it
Hän tuli tunnin sovittua aikaa myöhemmin.	fi
Ideje bezárni a kaput.	hu
Давай это сделаем.	ru
Le concert se déroule tous les ans à Lyon.	fr
Том пригубил вино, налитое ему Мэри.	ru
Stinkaj odoroj klare indikas, ke la nutraĵo estas forĵetenda.	ep
Szeretnél hozzám csatlakozni?	hu
Lo voglio andare a vedere quando esce questo film, chi viene?	it
6 méter anyagot vettek a ruhához.	hu
I had to beg my friends to come.	en
Wiesz, że nie chciałem cię obrazić.	pl
Ambaŭ ŝtatestroj telefone diskutis la situacion en la oriento de Ukrainio.	ep
La virgola non è sempre utilizzata per indicare una pausa.	it
Tom sagte, er sei leicht erkältet.	de
Boston'da bir teyze ve amcam var.	tr
Tom zawsze uważa, że ma rację.	pl
Il forte vento indica che sta arrivando una tempesta.	it
Did Tom eat everything on his plate?	en
Разумеется, он не желает со мной разговаривать.	ru
Ĉu vi povas priskribi, kiel Tomo mortis?	ep
Tom possiede davvero molte macchine.	it
Ci vorrebbe un ettaro di terra.	it
Tom passed out on the couch.	en
Non faccio piangere le loro figlie.	it
Тебя не тошнит?	ru
No tengo hijos.	es
Güzel bir teklif sundu.	tr
Widziałem wschód Słońca.	pl
Er arbeitet im Kraftwerk.	de
I won't hold my breath.	en
Welches ist die Sprache mit den meisten Sprechern?	de
Oh, indeed those long winter days were very dreary. But at last spring came, with warm sunshine.	en
Se vi ne volas fari paroladon, ne sentu vin devigata.	ep
Marie adorava la poesia.	it
Si preparano.	it
I knew you wouldn't want to go to Boston with Tom.	en
Tom kunde inte minnas vad de hade pratat om.	se
Bunun iyi haber olmadığını yüzünden söyleyebilirim.	tr
Onlar Japonya'ya geldiğinden beri beş yıl geçti.	tr
What was the matter with her?	en
Tom geht regelmäßig zur Kirche.	de
Lo spezzatino ha un odore delizioso.	it
Tom zostawił niezakluczone drzwi.	pl
Gli piacciono le arance?	it
Sono l'unica che è d'accordo con lei?	it
Мы можем поговорить с ней.	ru
До какого времени я могу тебе позвонить по телефону?	ru
A vállalatot ő alapította.	hu
Vidu, kion mi ellaboris!	ep
I had to lie to everyone.	en
Milyen korán kelők lettünk.	hu
Mi kifogásod van ellene?	hu
Том си го вовлече здивот.	mk
माझ्या मावशीला तीन मुलं आहेत.	ma
Ben fotojenik değilim.	tr
Нам придется сделать это потом.	ru
En la malvarmujo estas botelo da blanka vino.	ep
Senki ne álljon az utunkba!	hu
Долгая война наконец закончилась.	ru
Datemi le mani.	it
Birisi beni aradı mı?	tr
Bagajıma dikkat et.	tr
Пожалуйста, скажите мне, что это шутка.	ru
Bunun zehir olmadığından emin misin?	tr
Се обидував да ѝ помогнам.	mk
Sən məktəbə getməlisən.	az
Eu não tenho filho nenhum.	pt
Никель - твёрдый металл с серебристым блеском.	ru
Одевме по улицата.	mk
Таа е сѐ уште малолетничка.	mk
Todo lo hipermedia es multimedia, pero con la adición de un atributo particular: todos los medios, no solamente el texto, pueden funcionar como hiperenlaces.	es
Не го разгневувај Том.	mk
Топло беше последниве неколку дена.	mk
Toma nie ma teraz w domu.	pl
Он победил на следующих выборах.	ru
Sto soltanto cercando di proteggervi.	it
I want him to be arrested.	en
Erkölcstelen vagy.	hu
Lütfen benden bir şeyler çalmayı bırak.	tr
Картофельное пюре часто подается с подливой.	ru
Non ha credibilità.	it
Molte persone sono in disaccordo con te.	it
Chcę, żebyś poznał mojego przyjaciela.	pl
Fiyaskosun.	tr
The most beautiful words are those that speak of love.	en
Но есть люди, которые выбирают дружбу, а не любовь, потому что боятся потерять друга. Они боятся попробовать, потому что знают, что если они попробуют и у них не получится, то исчезнет даже дружба.	ru
Я езжу на «порше».	ru
O benim için şemsiyemi onardı.	tr
Tom belli ki onun hakkında bilmiyordu.	tr
Том, похоже, не понимает, что происходит.	ru
В целом, это был успех.	ru
Elle veut le prendre dans ses bras.	fr
Я не знаю, когда начинается вечеринка.	ru
Onların işi kitapları ciltlemek.	tr
Том - брат-близнец Джона.	ru
Li estis nomumita japanuja sendito por Meksiko.	ep
Я не стыжусь того, что мы сделали.	ru
O ekim ayında oldu.	tr
Warum sollte Tom irgendwie anders sein?	de
Sono stata al centro commerciale.	it
Ben altmışıncı boşanma krizim sırasında Vancouver'da yaşadım.	tr
In diesem Alter ist es nicht möglich, sich zu ändern.	de
Ymmärrän, mitä se tarkoittaa, mutta en osaa kääntää sitä.	fi
Tomo estas kverelanta kun sia edzino.	ep
Вот твой чай, Том.	ru
A voi piace passeggiare?	it
Tom'a bir kez yardım ettik.	tr
Non so se ho abbastanza tempo.	it
Não era dela.	pt
Ne fidu al li.	ep
Я сейчас не хочу ужинать.	ru
Hiç kimse onu tanıyor gibi görünmüyor.	tr
Vi dirò tutto a riguardo domani.	it
Je me suis mise à avoir chaud.	fr
İran Irak değildir.	tr
Miaj plej ŝatataj fakoj en la mezlernejo estis geometrio kaj historio.	ep
Plu ne ĉiam plibonas.	ep
今年也有業餘音樂會。	zh
Она умерла, не оставив потомства.	ru
Tom ha molti amici potenti a Washington.	it
Uçak uçurmayı öğrenmek istiyorum.	tr
Mi foriru morgaŭ matene.	ep
गैरहजर कोण आहे?	ma
Том не мог позволить себе нанять адвоката.	ru
Tom ve Mary'nin arka bahçelerinde tavukları var.	tr
She tries to fool anyone.	en
Dan etiketi bile kaldırmadı.	tr
È vero che Tom si è ucciso?	it
Questo devi negarlo.	it
Dovete salvare Tom.	it
Ты получила, что хотела.	ru
Eu amo tua filha.	pt
Tom è venuto a trovarti.	it
Lui ce l'ha scritto in faccia che è persona poco istruita.	it
They're pretty sick.	en
Ni kunrestadu kune momenteton.	ep
Deve essere ottimista.	it
Kütüphanede buluşalım mı?	tr
Açıklamıyorum.	tr
O que realmente está acontecendo?	pt
Ĉu vi jam kisis knabinon?	ep
Ich hab’s!	de
Sono tanto famosa quanto te.	it
Mi piacciono i cellulari android.	it
Wtrącasz się.	pl
Ты так права.	ru
I guess that's how Tom found me.	en
Iuj beduenaj vilaĝoj en Negebo estis detruitaj kaj rekonstruitaj pli ol dekfoje. La beduenoj de Negebo estas en sia propra lando kaj absolute rajtas vivi tie.	ep
Tom bana Boston hakkında çok soru sorardı.	tr
Un espion peut être dans les environs.	fr
New York is the busiest city in the world.	en
A cup of coffee relieved me of my headache.	en
Do you believe in Christianity?	en
You should think before you begin to speak.	en
The Star Festival is in July.	en
I have to stay home.	en
We beat that team by 2-0.	en
I'd like you to cut my hair.	en
He is as lean as a wolf.	en
He has a nice build.	en
She accepted his offer.	en
Do you know where my watch is?	en
Look, today was 'sea harvest' so let's go forage for edible plants tomorrow!	en
To bardzo uprzejme z twojej strony, że schłodziłeś mi wino.	pl
L'apogée des Romains est passé.	fr
Ich möchte es auf jeden Fall sehen.	de
Mój dziadek lubi spacerować.	pl
Eu consigo fazer sozinho!	pt
Je ne peux comprendre cela.	fr
Lui et moi sommes amis depuis le bac à sable.	fr
À cause des fortes chutes de neige, ils ont retardé leur départ.	fr
Je la oka mi estos preta por la laboro.	ep
Restis nenio en la fridujo.	ep
Bonvolu ŝalti la reflektoron.	ep
Kiom kostas tiu ĉi tenilo?	ep
Mi igis la ĝardeniston planti kelkajn arbojn.	ep
A ponadto, zaczyna padać.	pl
Va in biblioteca per leggere libri.	it
Est-ce que votre pays possède l'arme nucléaire ?	fr
The astonishing blow finished the match.	en
Это не совсем то, чего мне хотелось.	ru
Dio ha creato il mondo in sei giorni.	it
Osaatko valmistaa kalaa?	fi
Tu ne devrais pas juger les gens d'après leur apparence.	fr
Schau mir in die Augen und sag mir, dass du es nicht getan hast.	de
Taisez-vous !	fr
Não, eu acho que não.	pt
Vous donnez beaucoup d'importance à ce qu'il dit.	fr
Mi dica cos'ha fatto a Shounan.	it
Mi petis ŝin, atendi dum momento.	ep
Mi preferus morti ol edziĝi kun li.	ep
Je mange une poire.	fr
Vergeet me niet op te pikken om zes uur morgenochtend.	nl
Bu konuya farklı açılardan bakmalısın.	tr
Mia frato preferas ventosurfadon.	ep
Benim bu iş için nitelikli olduğumu düşünüyor musunuz?	tr
Le type ne pouvait même pas écrire son propre nom.	fr
Tudo o que eu disse foi o que ouvi.	pt
Tengo muchos amigos que pueden ayudarme.	es
Geçen yıl sağlık kontrolü yaptırdın mı?	tr
Jeg misunder hans succes.	dk
¿Almorzaron Ken y Joe a eso del mediodía?	es
Él se casó dos veces y tuvo más de 20 hijos.	es
Lei spacca.	it
Siento no haber contestado tu carta antes.	es
El león es usado a menudo como símbolo de coraje.	es
La afero finiĝis feliĉe.	ep
Wir brauchen eine Koordinierung der Wirtschaftspolitik der Euro-Länder.	de
Fu punito perché aveva mentito.	it
Deberías saberlo.	es
Se ele nos pedir ajuda, nós o ajudaremos.	pt
Nous t'exorcisons, tout esprit immonde, toute puissance satanique, toute incursion de l'ennemi infernal, toute légion, toute congrégation et secte diabolique.	fr
Are you saying you intentionally hide your good looks?	en
Sur la route, elle a vu beaucoup d’animaux.	fr
Quando nós vamos para casa?	pt
Plötzlich stieg der Wasserstand des Flusses, und er verließ sein Bett.	de
Io voglio questo frutto.	it
Je planifie aller au théâtre aujourd'hui.	fr
¡No toques esto!	es
Aquele homem morreu de câncer no pulmão na semana passada.	pt
Rusia ha despertado.	es
Solcherlei hat noch nie jemand zu mir gesagt.	de
In fact, the difference between Bristish English and American English is more important than between standard Flemish and the standard Dutch of the Netherlands.	en
We bought a pool table but have yet to play a single game.	en
Yarım-doktor seni ve yarım-din alimi inancını öldürür.	tr
Estás en el tren equivocado.	es
Quem te ensina alemão?	pt
Did you use a condom?	en
Boję się, bo ostatnio jest coraz więcej trzęsień ziemi.	pl
Ich habe bis zum Wochenende noch viel Arbeit zu erledigen.	de
Pedimos a Hanako que tocasse piano.	pt
The first time I had Sushi was fantastic.	en
Elle m'a dit de la rencontrer chez elle.	fr
La festa di Trang era divertente come una veglia funebre.	it
Entschieden ward des Menschen Los durch nichts als einen Apfel.	de
Vi ne forgesu vian ĉefan celon.	ep
Daran ist nicht zu zweifeln.	de
Девчачью болтовню не остановишь.	ru
Minä taidan olla ainoa aamu-uninen.	fi
У меня так много работы, что я останусь еще на один час.	ru
En vintro oni hejtas.	ep
Первые девять лет жизни Макса прошли в Киле.	ru
Tu cachais ton argent.	fr
Werden sie sich nach so langer Zeit noch daran erinnern, was sie euch versprochen haben?	de
Down with the king!	en
The spectators in the gallery were making a lot of noise.	en
Oni ne povas traduki tion.	ep
Czy on tu jeszcze jest?	pl
Non scorderò Tom.	it
मला एक ग्लास दूध दे.	ma
Neniu povas anstataŭi vin.	ep
Onları yenmedik.	tr
Это спорно.	ru
Neben ihm saß meine Mutter, ein schwarzer Umriss vor der roten Glut des Feuers.	de
Voulez-vous un petit-déjeuner ?	fr
Tom è qui dentro.	it
Tom could see that Mary was texting.	en
Do you need something to drink?	en
Olet lisännyt kommentin, et käännöstä. Lisätäksesi käännöksen, klikkaa lauseen yläpuolelle olevaa ”あ→а”-kuvaketta.	fi
Vai a giocare a baseball!	it
Sosem viseltem szmokingot.	hu
A hidat a rómaiak építették.	hu
Lull your baby to sleep.	en
Melanie boit du lait.	fr
Ich wusste nicht, was antworten, und sagte nichts.	de
ខ្ញុំ​ចង់​ទៅ​ជាមួយ​អ្នក​។	kh
We like our life.	en
When did Tom get here?	en
Non ha ottenuto il lavoro.	it
Are we going somewhere now?	en
A hölgynek szüksége volt valakire, aki megérti őt.	hu
O kadar uzun süre burada olmayacağım.	tr
Entschuldigen Sie! Ich habe Sie nicht verstanden.	de
Tom spricht fast nie französisch.	de
Позвони своему брату.	ru
Io pensavo che questo potesse capitare.	it
Onu bağışlayamıyorum.	tr
Er hat sich nach Kyūshū aufgemacht.	de
Près de ma maison coule une petite rivière.	fr
L'ho vista piangere.	it
A Holanda é a pátria das tulipas.	pt
Han gjorde det helt på egen hand.	se
La gusto de mia edzino koncerne vestadon estas la malo de la mia.	ep
La domo estis subfosita de la inundo.	ep
J'étais très impressionné.	fr
Открыто.	ru
Tom won't talk about that.	en
A lógica feminina nem sempre tem lógica.	pt
È una circostanza che esclude il senso di colpa.	it
Voi avete mai mangiato una torta alla banana?	it
Ni ne venis.	ep
Этот вопрос имеет большое значение для меня.	ru
Recently, Tom has been worrying about his future.	en
My father is here.	en
Tanssijatar hetkutteli lanteitaan viettelevästi.	fi
Er ist mit einem Schiff gereist.	de
Tom wasn't surprised at all.	en
Tom neredeyse yanlış kapıyı açıyordu.	tr
Tom n'a pas fait de commentaire.	fr
Rıhtımı gerçek bir kasırga vurdu.	tr
Это был самый популярный вид спорта в этой стране.	ru
तुम्ही नक्की काय पाहिलंत?	ma
Схожу-ка я с ума.	ru
Ay, dünyanın etrafında döner.	tr
That'll take a long time.	en
Perché eravate in ritardo?	it
Dat is een leuk verhaal.	nl
Du wurdest geliebt.	de
La prossima volta che la vedo, mi dia la sua risposta, per piacere.	it
O que você espera de sua vida?	pt
Tom ve Mary asla birbirlerini eleştirmedi.	tr
Oletko varma, että tämä on se, mitä Tom halusi meidän ostavan?	fi
Como se diz "Como se diz 'Eu comi uma maçã.' em lojban?" em lojban?	pt
Her insan farklıdır.	tr
Kuntekste de la maltrankvilego esprimita de Angela Merkel pri la okazaĵoj kaj en Krimeo kaj en Ukrainujo Vladimir Putin referencis al la nemalpliiĝanta minaco de perforto per ekstremnaciismaj fortoj, kiuj endanĝerigas la vivon kaj la laŭleĝan intereson de rusaj civitanoj kaj de la tuta ruslingva loĝantaro.	ep
Der Beteuerung, dass alle am gleichen Strang ziehen, möchte ich gerne glauben, aber in die gleiche Richtung wäre für mich noch schöner.	de
Böyle şeylerin burada olması gerekmiyor.	tr
Я и так уже сказал слишком много.	ru
Will you do as much as you are able to?	en
Ele deixou o circo, aplaudido pelo público.	pt
Bana henüz adını söylemedin.	tr
Том ушёл домой.	ru
Wo ist der Fehler?	de
Так это же замечательно!	ru
Dan a confirmé le version des faits de Linda.	fr
Kesinlikle onunla konuşacağım.	tr
Учора я была вельмі шчаслівая.	be
Почему ты не можешь меня простить?	ru
Ben yalnızca onun hakkında konuşuyordum.	tr
Нема отров во рибава.	mk
Системот за подмачкување беше лошо осмислен.	mk
Tom heard footsteps outside his door.	en
Включи мозги.	ru
Egy óránál is többet vártam.	hu
Deixaste as luzes acesas.	pt
Немаше никого друг таму.	mk
Onun izin talebi reddedildi.	tr
Kiom el inter ni havas tiun ŝancon?	ep
Jouez-vous dans une fanfare ?	fr
Did Tom find him?	en
要冷静。	zh
O, karısı onu terk ettikten sonra oldukça kindar oldu.	tr
Мы тебе не нужны.	ru
Я аргентинец.	ru
Се гледаме во понеделник.	mk
Амазонка — вторая по длине река в мире после Нила.	ru
Што е тајната?	mk
Се надевам дека Том греши.	mk
Tom túl fiatal.	hu
Том е толкав кретен.	mk
Витамин С также известен как аскорбиновая кислота.	ru
Csak egy érzés volt.	hu
Je peux maintenant le dire, il fut un temps, je détestais Tom.	fr
Det hände.	se
Már beszéltem Tomival ebben az ügyben.	hu
Is the pain unbearable?	en
Megtaláltad, amit kerestél, fiam?	hu
Сюзан хорошо готовит.	ru
Никогда никому не давай советов.	ru
Это не будет для меня большим убытком.	ru
Tom'u son bir kez görmeni istedim.	tr
Nem hiányoznak nekem.	hu
Mach es nicht schwierig, Tom.	de
Odanı temiz ve düzenli tut.	tr
Todas as tuas perguntas serão respondidas.	pt
Neden birinin Tom'u öldürmek istediği konusunda herhangi bir fikrin var mı?	tr
Svegliarsi presto la mattina talvolta è molto difficile, specialmente quando fa freddo.	it
Ich bitte dich, dass du nichts änderst!	de
You should come over.	en
Ich werde meine Kinder nicht verlassen.	de
Ich riss die Kartoffeln nicht heraus.	de
Nous ne sommes pas seuls.	fr
Bir omlet yapabilir misin?	tr
Tom seninle konuşmak için isteklidir.	tr
Vi simple obeu la instrukciojn.	ep
Вы мне очень нравитесь!	ru
Том наблюдал за гонкой в бинокль.	ru
Я слышал, что вчера вечером вы с Томом работали допоздна. Это так?	ru
Pentri japanan flagon estas tre simple.	ep
Quem de vocês fala bem o Francês?	pt
Onun seni sevdiği açık.	tr
That's what people don't understand.	en
Neredeyse bir yıl içinde Tom'la konuşmadım.	tr
Sorun güneş enerjisinin çok fazla maliyetinin olması.	tr
Wie ist der Name jenes Restaurants?	de
O seu português é diferente do meu.	pt
İnsan ateşi kullanan tek hayvan.	tr
Agora, prestem atenção.	pt
La luno helas.	ep
Kutime Tomo ne bezonas labori lundon posttagmeze.	ep
Manĝegu!	ep
Tom saltó fuera de la cama.	es
Что он там опять за номера выкидывает?	ru
Elle est lâche.	fr
Ben o kadar hayal kırıklığına uğramadım.	tr
"How are you?" "Very well."	en
All questions have answers.	en
Que se passe-t-il à Tatoeba ?	fr
Vous mangiez des tomates.	fr
Malvarmis.	ep
O muhtemelen bir işarettir.	tr
Уверен, что ты слышал взрыв, прогремевший в Стамбуле.	ru
Tom'un söylediği her şey bir yalandı.	tr
Я должна быть наказана.	ru
En ĉiuj tiuj pantalonoj estis poŝoj, en kiuj ni konservis nian naztukon.	ep
Tom and Mary need to relax.	en
Li estis sidanta.	ep
Ho bisogno che andiate al supermercato a comprare del latte.	it
La camera aveva un cattivo odore.	it
Non sono sicura che Dio esista.	it
Ĉu vi ankoraŭ resaniĝas de la lasta nokto?	ep
Tout le monde peut faire mieux.	fr
I love the game of basketball.	en
Я читал такую.	ru
Milyen volt az út?	hu
Том, наверное, тебя любит.	ru
তুমি কি এই গানে নাচতে পারবে?	bj
Tom is a pretty unique individual.	en
Lo sta facendo adesso.	it
入场费是3美元。	zh
Çok hızlı harcayanlar asla zengin olmazlar.	tr
Ĉiuj policistoj de la urbo serĉas vin.	ep
L'identité du meurtrier reste inconnue.	fr
Je cherche un vieil homme.	fr
Send me a racket and my tennis shoes.	en
Please feed the dog every day.	en
Where did you pick up those old coins?	en
Je lui dois $100.	fr
It is necessary to prepare for the worst.	en
He told her firmly to realize how serious her condition was.	en
Per favore, non parlare così veloce.	it
Sono stato a Kyoto una volta.	it
Nasz syn zginął na wojnie.	pl
Posso chiamarti Bob?	it
Questo famoso direttore d'orchestra abita a New York.	it
Ze werkte uitsluitend voor het geld.	nl
Elle est née dans une génération juste après l'esclavage ; à une époque où il n'y avait ni voitures sur la routes ni avions dans le ciel ; à une époque où quelqu'un comme elle ne pouvait pas voter pour deux raisons — parce qu'elle était une femme et à cause de la couleur de sa peau.	fr
My sister shelled the beans.	en
Edzo kaj edzino estas nur unu.	ep
Mit navn er Farshad.	dk
Li malfruiĝis por la lernejo hieraŭ.	ep
Mi ankoraŭ neniam vidis lin porti ĝinzon.	ep
Por malfrua gasto restas nur osto.	ep
Sechs Monate später waren wir verheiratet.	de
Of ge uw baard vier of zeven jaar laat groeien, onder het mes van de barbier valt hij in even veel tijd.	nl
Sie wählten ihn zum Vorsitzenden.	de
Lei può essere carina, però non mi piace.	it
Warst du schon mal in dieser Wirtschaft?	de
Sie werden nervös.	de
Outre la pluie, nous avons eu des vents très forts.	fr
Láttam már korábban azt a képet.	hu
Parece obvio que él es incapaz de nadar.	es
Kommen sie um zehn Uhr morgens oder abends an?	de
Dieser Mann ist tot.	de
It is not raining.	en
Powierzchnia ziemi była pokryta kobiercem opadłych liści.	pl
Il croit fermement qu'il a été enlevé par un OVNI et a fait l'objet d'expérimentations par des extra-terrestres.	fr
Santa Ana's army was destroyed.	en
Parents were hopeful about the future.	en
Quelqu'un sait-il comment on peut gagner de l'argent en temps de crise ?	fr
你想吃什麼就吃什麼。	zh
Bitte schauen Sie mal bei Gelegenheit vorbei, wenn Sie einkaufen gehen oder ähnliches.	de
Ich habe diesen Brief auf Französisch geschrieben.	de
Det här kommer att bli den varmaste sommaren på trettiosex år.	se
Ĉi-matene mi iris al la parko.	ep
Sie hat keine Angst vor dem Tod.	de
Posso ver aquele ali?	pt
Li ĉiam perdas tempon per bagatelaĵoj.	ep
A única razão que a levou a aceitar foi porque você o pediu.	pt
Mi sento in obbligo ad andarci.	it
Çoğu öğrenci okul gezilerinde Kyoto'nun görülmeye değer yerlerini geziyorlar.	tr
Keiko memberitahu aku tentang kedatangan pesawatnya.	in
Lia suno estas subiranta.	ep
Mi faccia finire.	it
Bir şey mi oldu?	tr
Vas a casa de Sandra, ¿no es así?	es
Ella es agente del FBI.	es
Tom sadece nasıl hissettiğini bilir.	tr
Tom'un USB kabloları ile dolu bir çekmecesi var.	tr
Vi ne havas la testikojn, por traduki ĉi tiun frazon.	ep
Où sont tes clés ?	fr
Tom kennt nicht den Unterschied zwischen Hamlet und Shakespeare.	de
La pozicio de la loĝantaro rilate al la eklezio variadas.	ep
Sorun Nancy'nin kulüp toplantılarına gitmemesidir.	tr
Mi ne pensas, ke vi devus.	ep
O, onu yapması için onu zorladı.	tr
Ich mische mich da nicht ein.	de
O povo queria proclamar Washington rei.	pt
A quem devem obedecer os marinheiros? - Os marinheiros devem obedecer ao comandante do navio.	pt
Cada qual pode em toda idade aprender o Esperanto.	pt
Vi ne devas respondi al ĉi tiu demando.	ep
Viele reiche Leute wohnen in diesem Viertel.	de
Tyttö kaunistuu päivä päivältä.	fi
Olviden y perdonen.	es
Mi ne estas sorĉisto.	ep
No entiendo qué trata de decir el autor.	es
Je me suis réchauffée dans le bain.	fr
It seems like he knows the secret.	en
Посмiхнись зараз, поплачеш потiм!	ua
On się szybko uczy.	pl
Il agit de son propre chef.	fr
Talvolta bisogna sapere quando ci si deve arrendere.	it
La soberbia es un caro placer.	es
The teacher warned us that the test would be difficult.	en
Nous avons tendance à commettre des erreurs.	fr
Wie alt ist deine Katze?	de
Laurie esprimas sin.	ep
Beruházás nélkül nincs fejlődés.	hu
La educación es una cosa admirable, pero es bueno recordar de tiempo en tiempo que nada que amerita saber puede ser enseñado.	es
Ich hämmerte einen Nagel in die Wand, um ein Bild aufzuhängen.	de
Noi siamo fratello e sorella.	it
Sie müssen spätestens Sonntag zurück sein.	de
Vi licenzio.	it
How did you get those?	en
É um primo meu.	pt
Je ne casse rien.	fr
È sicuro di non volere mangiare qualcosa?	it
Das ist unter ihrer Würde, so etwas zu sagen.	de
La economía japonesa todavía es estable.	es
Je ne compatis pas avec toi.	fr
No tengo suficiente dinero para comprarlo.	es
Az önce elektronik postanı aldım.	tr
Der dritte Tag der Woche ist der Mittwoch.	de
Jag kan inte minnas hans namn.	se
Gözlerin sesimin yankısını yansıtıyor.	tr
Da bambino, Bob viveva a Boston.	it
Pourquoi ne démarrez-vous pas ?	fr
Lubiłem to.	pl
Колко е стара Айфеловата кула?	bg
Ich fahre ein schwarzes Auto.	de
Légy bátor és ne veszítsd el a reményt.	hu
Freundschaft ist ein Band der Vernunft.	de
I haven't seen this movie before.	en
I just wanted to tell you something.	en
La momento, kiam rekomenciĝos la kunveno, estas necerta.	ep
Ĉu vi renkontis Filipon?	ep
Je pense que vous devriez prêter plus d'attention en cours.	fr
Nimm die Sendung auf Band auf.	de
Marc me dijo que no vendrá mañana.	es
I think you've done this before.	en
Tomo naŭziĝas.	ep
Are you as excited as we are?	en
Ni bezonas lokon por tranokti.	ep
Non andare nella mia stanza.	it
You'll have your turn.	en
La juĝisto kondamnis lin al kvin jaroj de malliberejo.	ep
Die Archäologen glauben, den Palast König Davids entdeckt zu haben.	de
Ne içiyoruz?	tr
We're looking forward to hearing from you soon.	en
Ich freue mich so, dass du wieder zu Hause bist!	de
Devi tenere pulita la tua stanza.	it
Эти дома принадлежат моему дяде.	ru
Marche sur les pavés.	fr
¿Va usted al teatro esta tarde?	es
It wouldn't be fair.	en
Tio ne povas daŭri tiel!	ep
Tom didn't have as much trouble falling asleep as he thought he would.	en
Zij heeft mij het visoogobjectief gegeven.	nl
Том был весь в чёрном.	ru
Ik moest de regels veranderen.	nl
Sen olduğunu düşündüğün kadar akıllı değilsin.	tr
Tiu libro estas tro malfacile legebla en la daŭro de unu semajno.	ep
Tom spuścił wodę.	pl
Alicenek múlt vasárnap óta meghűlése van.	hu
Mi volas, ke vi iru supren.	ep
Il cancello è sufficientemente largo perché ci passi l'automobile.	it
Non si smentisce mai.	it
Това беше краткото затишие преди опустошителна буря.	bg
Bu gerçekten büyüleyici.	tr
Älä unohda ladata kännykkääsi.	fi
Li promesis, ke li ne ree malfruos.	ep
La conférence sur les artistes impressionistes était intéressante.	fr
In tutti i casi, è discutibile.	it
Does that seem like something we can do?	en
El sol brilla para todos.	es
Его жизнь полна проблем.	ru
Ще Ви се обадя по-късно.	bg
You take a drink, then you elbow to the buffet and eat like a pig!	en
Tom on komea mies.	fi
Это мой друг из Японии.	ru
Il y a deux manières de conquérir et asservir une nation. L’une est par l’épée. L’autre par la dette.	fr
Du solltest eine Feldflasche Wasser mitnehmen.	de
Tom is writing a letter now.	en
"Cinsiyetçilik" gibi terimler şimdi moda.	tr
Я нанял Тома.	ru
Dovreste essere pronte al peggio.	it
Comment pourriez-vous ne rien dire ?	fr
Che mani spettacolari!	it
Я по ошибке убил ящерицу.	ru
Если бы я знал, что ты здесь, я бы не пришёл.	ru
Mia patro aĉetis por mi biciklon.	ep
Ĉi tie estas iu, kiu vizitas vin.	ep
Ella pensó que estaba reconociendo, debido a un retrato, al gran escritor.	es
Sandıktan bakalım kim çıkacak?	tr
¡Gracias, Tom! Me encantan las flores.	es
Tom no solo enseña guitarra, él seguido da conciertos.	es
Ĉu mi eniru?	ep
Io sono una banana.	it
Вы умеете стоять на руках?	ru
Tom is resigned to his fate.	en
Is it time you need?	en
Tom bizimle voleybol oynardı.	tr
Creo que Shakespeare es el mejor dramaturgo que jamás haya vivido.	es
I capelli corti le stanno veramente bene.	it
Tom näkisi tämän oikein mielellään	fi
Tom ei aloittanut ranskan opiskelemista kuin vasta kolmekymppisenä.	fi
Meddig maradtok Kijevben?	hu
A hétvégét barátaim társaságában töltöttem.	hu
Knaboj pasigas pli da tempo ol knabinoj je la komputilo kaj la interreto.	ep
Bu kutu bir ton ağırlığında.	tr
Ért magyarul?	hu
Я не могу его понять.	ru
Eu não mentirei para ele.	pt
Ne számíts arra, hogy mindenki osztani fogja ezt a véleményt.	hu
Az ördög vigye el, ezt nem kalkuláltam be!	hu
Lipitor gyógyszert veszek be.	hu
Дали си полудел?	mk
Aku seharusnya tidak menerobos lampu merah itu.	in
Azok, akik nem tudnak magukon nevetni, meghagyják ezt másnak.	hu
Зарем не можеш да ми помогнеш?	mk
Misschien had je toch gelijk.	nl
Lo so che sembra sciocca.	it
Le chiameremo.	it
Што ја праша?	mk
Te fâche pas.	fr
Onun ne yapacağı belli olmaz.	tr
Tom'un sadece biraz yardıma ihtiyacı var.	tr
Они называют нас россиянами.	ru
Треба да му се јавиш на Том.	mk
La polizia la metterà in prigione.	it
Szeretne kibékülni veled, s neked is engedékenynek kell lenned.	hu
Istuin narahti hänen istuessaan.	fi
Hast du eine Meinung diesbezüglich?	de
Daha temiz dişlere sahip olmak istiyorum.	tr
Kuglo trafis la koron de la soldato.	ep
Я хочу пони.	ru
Ciò è sospetto.	it
По-моему, ты мне должен десять долларов.	ru
Hvad slags planer har du for weekenden?	dk
Tomo diris al Mary, ke laŭ li ŝi estas la plej bela virino, kiun li iam renkontis.	ep
Úgy döntöttem, hogy nem érdemes erőltetni.	hu
Esqueça isso a partir deste momento.	pt
Não dependa de Tom.	pt
La lengua oficial de Israel es el hebreo moderno.	es
Valamikor eljön az igazság pillanata.	hu
Lui è molto meglio di me negli sport, per non dire altro.	it
Çocuklarım mutluysa, ben mutluyum.	tr
Kiun parton de Eŭropo ili ŝatus viziti?	ep
Como você deseja o seu café: preto ou com creme?	pt
Már nem volt ugyanaz, mint annak idején, mert Rosi jobbára mindig részeg volt.	hu
Entschuldigung, darf ich dein Lieblingsmensch sein?	de
Властям удалось стабилизировать курс валюты.	ru
Para nerede, Tom?	tr
Что ещё могла хотеть девушка?	ru
Ben kabızım.	tr
Обслуживание здесь отвратительное.	ru
Bu sabah bir diş hekimi randevum vardı.	tr
Hová tegyem ezt?	hu
Quanto o Tom ganhou ano passado?	pt
La grammaire étant l'art de lever les difficultés d'une langue, il ne faut pas que le levier soit plus lourd que le fardeau.	fr
Я не знаю, чего хочу.	ru
Tom guardò l'anello che John diede a Mary.	it
O que estou comendo?	pt
Tomás se olvidó las llevas por lo que tuvo que treparse por la ventana.	es
Você não conversou com o Tom?	pt
Ni ĉiuj indas je ŝanco.	ep
Nós precisamos aprender a trabalhar juntos.	pt
Du verwirrst sie.	de
Tom escondeu os presentes de Natal das crianças debaixo do sofá.	pt
Ele é tão sábio quanto se diz?	pt
Those twins are identical, not only their faces, but also in their characters.	en
Io ero pronto a farlo.	it
Mijn huis is heel koud.	nl
Я хочу, чтобы вы сделали это прямо сейчас.	ru
Io non ce la farò mai in orario.	it
Я сегодня не собиралась плакать.	ru
Io non sono stata in grado di farmi capire.	it
Dan, Linda'nın seksüel önerisini reddetti.	tr
Kötü bir soğuk algınlığı olmasına rağmen çalışmak zorunda kaldı.	tr
Gettate l'ancora!	it
Mi volas mian monon.	ep
Тебе придётся это сделать, нравится тебе это ли нет.	ru
Alles Wissen geht aus einem Zweifel hervor und endigt in einem Glauben.	de
Kiom aĝa estas via edzino?	ep
La viro estas en la kuirejo.	ep
J'ai confondu Tom avec son frère.	fr
Tom bir lise müdürüdür.	tr
Mindjárt megvan!	hu
Я помогу вам искать Тома.	ru
Так поздно?	ru
Vada a dirlo a loro.	it
¿Tom ha prometido ayudarnos?	es
No te comportes como un imbécil.	es
Vuoi dire che a casa vostra c'è un fantasma?	it
I got tickled the other day.	en
The voters want change.	en
Я думал, что ты мужчина.	ru
Je me suis égaré et j'ai eu du mal à retrouver le chemin de l'hôtel.	fr
Where did you find that doll?	en
That is why he did not agree to what they had proposed.	en
It was the window that Jack broke yesterday.	en
I waited for the answer but nobody answered.	en
I don't have to apologize for what I said.	en
He is delighted at your success.	en
He works for a mere pittance.	en
She did without necessities to pay for her daughter's lessons.	en
Si seulement il n'y avait aucune guerre dans le monde.	fr
Так-так, - произнес доктор. - Надо её осмотреть.	ru
Mörker är frånvaro av ljus.	se
The Defense Enrollment Eligibility Reporting System is also called DEERS.	en
Each man calls barbarism whatever is not his own practice.	en
你看，桌子上还放了一叠校样。	zh
Les pommes sont rouges ou vertes.	fr
Partageons la récompense cinquante-cinquante.	fr
Чтобы прочитать ответ, просто щёлкните по вопросу.	ru
Ég vinn hér. Ég er enginn gestur.	is
Kako se kaže "Hvala" na japanskom?	hr
O que teu marido te deu por ocasião do teu aniversário?	pt
Vere mi volas motorciklon.	ep
Mia patrino aĉetis al ni hundidon.	ep
Zawsze chodzę do szkoły.	pl
Bazı doktorlar hastalarını memnun etmek için bir şeyler söylerler.	tr
La malsanasekurkotizoj denove altiĝis.	ep
¿Cómo estuvo el fin de semana?	es
Meine Schwester hat ein Klavier.	de
Ich würde gerne meine Wertsachen in ein Schließfach legen, wenn eines erhältlich ist.	de
Te is mész?	hu
Forgesu tion tuj.	ep
Még a légkör felső rétege is szennyezett.	hu
Ihre Hosen passen nicht.	de
Sie sollten das bald tun.	de
Sie wurde 1946 geboren, am 19. August, in Kalifornien.	de
Está chovendo muito nestes últimos dias.	pt
В этой комнате пахнет газом.	ru
我是新娘，你是新郎，我们结婚吧!	zh
Les daremos apoyo moral.	es
I shouldn't have gone there by myself.	en
Ĉu vi povas helpi al mi kun mia laboro?	ep
Было очень холодно.	ru
Şu genç adam bisiklete binmeye çok düşkün.	tr
Kaza olursa, bana bildir.	tr
C'est comme cela que le temps est complètement gâché.	fr
Antes vendíamos só alimentos, mas agora adicionamos novos produtos.	pt
A mí me obligaron a aprender español.	es
Quel con je fais !	fr
Ne méprise personne, parce qu'il est seulement pauvrement vêtu.	fr
Vediamo se è buono.	it
Tom uyuyormuş gibi yaptı.	tr
Ce qu'ils t'ont dit est exactement le contraire de ce qu'ils m'ont dit hier.	fr
Questo è il bello dell'Italia.	it
C'est pourquoi tant d'étudiants sont absents aujourd'hui.	fr
Togli le mani!	it
Gidelim Ken.	tr
Onun iki bin kitabı var.	tr
Elle a des yeux attirants.	fr
Li ne povis elekti momenton pli bonan.	ep
Ĉiun momenton la sorĉistino metis novajn objektojn en la kaldronon.	ep
La casa lleva años abandonada.	es
Korkacak bir şey yok.	tr
Nous sommes une famille de quatre.	fr
She's a lot better today.	en
Öğretmenim bana elimden geldiği kadar çok okumamı söyledi.	tr
After a tiring game of football, I think I will go to bed.	en
Ce garçon n'a montré aucune peur.	fr
Être un homme c'est être responsable.	fr
Tom havas kontuzitan okulon.	ep
Ne estas miraklo, ke la infanoj ŝatas viziti la kamparanan bienon.	ep
Ni tre allogiĝas al la kampara vivo.	ep
Tom si addormentò in classe.	it
Maalesef suçunu asla kabul etmeyecek.	tr
Ken es un estudiante diligente.	es
Du hättest dich höflicher ausdrücken sollen.	de
Tom diris, ke li volas, ke mi pasigu la someron en Boston kun li.	ep
Ich liebe Kinder.	de
Maria, sei nicht kindisch!	de
How many stamps do you have in your collection?	en
Az új felfedezés hasznosnak bizonyult a tudomány számára.	hu
Ŝi vere pasiiĝas pri trikado.	ep
Es demasiado pronto para que saquemos conclusiones precipitadas.	es
We're meant to be together.	en
Sie alle haben Angst vor Tom.	de
Das ist beschämend.	de
Je n'arrive pas à croire que tu ne sois pas au moins disposé à envisager d'autres possibilités.	fr
Bu şu ana kadar gördüğümüz en yoğun kar yağışı.	tr
Siehst du das Porträt?	de
Denne appelsin er velsmagende.	dk
Ты не хочешь делать этого.	ru
Dove andrà?	it
È molto riservato su ciò che riguarda la sua vita in famiglia.	it
Elle a pu être surprise en entendant les nouvelles.	fr
Robert Koch identificò il germe della tubercolosi nel 1882.	it
¿Quieren tener hijos?	es
Tout le monde a cané.	fr
¿Quieres saber lo que creo que está pasando?	es
Ne vous souciez pas tant de moi !	fr
Ŝi vivas en ĉi tiu kvartalo.	ep
Попадёт же мне, если я опоздаю.	ru
Hennes ansikte strålade av lycka.	se
Tom se ha vuelto más fuerte.	es
If there's anything that I've learned over the years, it's that I am nobody's savior.	en
Tom disagreed.	en
It's quite simple.	en
That's our business.	en
Li politike aktivis post la sendependiĝo de la lando.	ep
Ĉi tiuj noticoj jam estas ĝermo de la verko.	ep
Dies brachte der Gruppe einen finanziellen Verlust ein.	de
Mi povas atendi kelkajn horojn.	ep
"Ela gostou do filme?" - "Sim, gostou."	pt
Как се справя Том?	bg
I've always been smart.	en
El bebé que está en la cuna es muy rico.	es
Ŝia hundo ne estas tre rapida.	ep
Io ho mangiato molto stamattina.	it
Mi pensas, ke tio funkcios.	ep
Estas tiel varmege ekstere, ke mi volas pasigi la tutan tagon en mia klimatizita domo.	ep
Ni havas la monon nur por aĉeti malgrandan aŭton en la momento.	ep
Die langanhaltende Ruhe barg die Vorzeichen einer Explosion.	de
Quien ha subestimado a una mujer jamás lo hará otra vez.	es
Hätte ich das gewusst, ich wäre nicht gekommen.	de
Dobbiamo reagire più rapidamente.	it
Io non credo che Tom abbia potuto dire una cosa del genere.	it
Oha ya durmak yok yola devamdan kasıt hep ilerlemek miydi?	tr
Elektrische Lampen, die sich hinter einer Decke aus durchscheinendem, milchig-weißem Glas verbargen, warfen ein sanftes Licht auf die Schätze des Museums.	de
¿Qué tipo de cuadrilatero es?	es
Wir sind hier, um uns zu amüsieren.	de
Co on knuje?	pl
Tom relaxed a little.	en
तो पुस्तक वाचत आहे.	ma
Вы не знаете как?	ru
Loro non la disturberanno più.	it
I'm having an extremely hard time trusting you.	en
Ist Ihnen das denn zu wenig? Sind Sie unersättlich?	de
Mogę dostać łyżkę?	pl
Bem-aventurados os pobres em espírito, porque deles é o Reino dos Céus.	pt
Мы друг друга поняли?	ru
Devemos fazer o nosso trabalho o melhor que pudermos.	pt
Bonan nokton, Tom!	ep
Mehr als zwei Stunden lang saß ich neben seinem Bett.	de
Nem mesmo um poeta escreve sempre com tanta habilidade e harmonia.	pt
A minha prima nasceu prematura.	pt
Biraz doktor tavsiyesine ihtiyacım var.	tr
Войди в комнату.	ru
Du hast immer Unrecht.	de
Tom yarın gece tekrar Boston'da olacak.	tr
Mi kredis lin kuracisto.	ep
I gave the book to my friend.	en
Mi opinias, ke gravas la amikoj.	ep
Siete così fortunati ad avere delle amiche così buone.	it
Yoksulluk tesadüf değildir. Kölelik ve apartheid gibi insan ürünüdür ve insan etkinlikleriyle ortadan kaldırılabilir.	tr
Mia patro malŝatas, kiam mi legas la ĵurnalon dum la matenmanĝo.	ep
Wir möchten mit Tom sprechen.	de
La mia famiglia ha passato bene la Pasqua.	it
The old person breathed his last breath.	en
Lasst uns ein Glas Champagner trinken.	de
Что вы носите?	ru
Я домой.	ru
Ystäväni Kei ilmestyy aina heti paikalle, kun minulla on ongelmia, ja auttaa minua.	fi
Trabalhei muito hoje.	pt
Est-ce que Tom est buveur de café?	fr
Ich zeige dir, wie dieses Spiel geht.	de
Io perdo sempre le cose...	it
Le limousine Hummer sono il simbolo massimo del consumo di generi di lusso.	it
Ci siete?	it
Horladığımı kabul ediyorum.	tr
The wolf killed the lamb.	en
Bu iyi bir hikâyedir.	tr
Io non penso che Tom si sia ucciso.	it
You're completely surrounded.	en
Том изглежда обективен.	bg
Ha stack hål på ballongen med en nål.	se
Kanado estas tre malvarma lando.	ep
Bítur hundurinn þinn?	is
Voi avete suggerito l'idea a Marie.	it
Tom non voleva parlare di Mary.	it
Ricordo di averlo incontrato da qualche parte.	it
Tom se veía muy triste.	es
Dove le avete buttate via?	it
Lépj be!	hu
Tom ei halunnut Marin vahtivan hänen lapsiaan.	fi
Nagyon őszül a haja apukámnak.	hu
Du bist entschlossen.	de
От страха щенок напустил лужу.	ru
Вы недооценили его.	ru
Tom akan melewati Boston dalam perjalanan mengunjungi Mary.	in
Io lo sapevo che vi avrei trovate con Tom.	it
Io ho trovato il libro che ho cercato a lungo.	it
Ми се чини дека ќе кивнам. Дај ми марамче.	mk
You need to prune the roses.	en
Włosi nigdy nie piją kawy.	pl
İki dilli olmak normdur.	tr
Сите ѕуревме во Том.	mk
Pysy sinä siinä.	fi
Vous ai-je allouée assez de temps ?	fr
Ez az őrült tenyészti a csótányokat gyufásdobozban.	hu
Положи себе чего-нибудь.	ru
Не дојдовме тука по нив.	mk
У Тома никогда не было проблем в школе.	ru
De politie arresteerde een verdachte.	nl
Том нешто изеде.	mk
Не гаѓај со камења.	mk
Hay un teléfono público allí.	es
Тоа е откаченото.	mk
Minä tiedän niistä kaiken.	fi
Ma este sok férfival találkozom.	hu
Acredito que construirão um outro estádio em breve.	pt
Was it acceptable to you?	en
I can't listen to music at night anymore because my headphones broke.	en
Ők pilóták.	hu
Honnan ez a kötődés?	hu
Sen oldukça üzgün olmalısın.	tr
I'm keeping my mouth shut.	en
Я не знаю, и мне безразлично.	ru
Van egy kutyánk.	hu
Alışılmış olandan farklı bir bağlamda bir şey görmek şaşırtıcı olabilir.	tr
Are you sure you aren't cold?	en
Not all real things are logical.	en
Stetti a vagare sulle montagne per tutta la notte.	it
Vártam a válaszát. Talán nem kellett volna.	hu
Az alázat az, amitől e világ harmonikus lenne, de sajnos sokakban nincs meg.	hu
Ni plipezigos niajn valizojn.	ep
If I could visit any North American city, it'd be San Francisco, California.	en
Biletleri nerede alabilirsin?	tr
Velem is törödj, ne csak magaddal.	hu
Sanırım plana sadık kalmalıyız.	tr
Hän tulee sinne, satoi tai paistoi.	fi
Mennyi babája van már a gyűjteményében?	hu
¿Dónde aprendiste a bailar así?	es
Why would she lie about that?	en
Eu não vou para lugar nenhum segunda-feira.	pt
Kylien välinen etäisyys on noin kolme kilometriä.	fi
Мы уже почти закончили.	ru
Ты молилась.	ru
Mis padres se divorciaron cuando yo era todavía un niño.	es
Mis aastal su auto tehtud on?	ee
Vida confortável de camponês.	pt
Megfosztom a legjobbtól.	hu
Spiders and scorpions have eight legs.	en
O que você fará com este homem?	pt
Tom is a lot younger than Mary.	en
Я хочу, чтобы все оставались на своих местах.	ru
Simpatia ulo, envere!	ep
Vi lavis mian tolaĵon.	ep
Suyu kapatın!	tr
Jag spelar volleyboll nu.	se
Das verstößt gegen die Regel.	de
Va te faire cuire un œuf !	fr
Non capisco e non sono abituato a non capire. Per favore, lo spieghi ancora una volta.	it
Tom a regardé.	fr
Két sört legyen szíves!	hu
Том хотел попросить Мэри об услуге.	ru
Spero che non arrivi a quel punto.	it
Gelecekten geliyorum.	tr
Bence Tom, kiralamamız gereken adam.	tr
Том развернул на своём компьютере простенький веб-сервер.	ru
Том сказал Мэри, чтобы она заткнулась.	ru
J'aurais besoin d'un coup de main, par ici.	fr
Она вернулась в машину.	ru
Lei ha un coupon?	it
Ich werde dir sagen, was das ist.	de
Io gioco a pallacanestro con lei.	it
Non mi piace più.	it
In realtà sono impressionata.	it
Dans etmeyi sevmiyorum.	tr
I don't want to give up too much.	en
I want to know who is coming with us.	en
Je vous achèterai ce que vous voulez.	fr
Be prompt in dealing with the problem.	en
You may get a serious disease.	en
Il est beau et intelligent.	fr
Elle a pris son petit déjeuner tôt.	fr
Nous avons été contraints d'abandonner notre plan.	fr
How often did you go swimming last summer?	en
It was Jack that I met yesterday.	en
Raise your hand when I call your name.	en
Deer were once the main game.	en
He isn't worthy to take the lead.	en
He took me over to the island in his boat.	en
I will have her call you as soon as she comes back.	en
I awoke to find a bird in my room.	en
Promise di sposarsi con lei.	it
我和往常一样起得很早。	zh
In der Schweiz gibt es viele Sehenswürdigkeiten.	de
Proszę nie dotykać.	pl
Это хорошая гипотеза, она объясняет много вещей.	ru
She's got lovers for every day of the week.	en
Ég á ekki kött.	is
Ne plaĉis al ŝi loĝi en la urbo.	ep
La idea no es mala.	es
Je suis dégoûté de toi.	fr
Meine Wohnung liegt im vierten Stock.	de
Il peut nager très vite.	fr
Jeg gav hende alle de penge jeg havde.	dk
La malriĉa homo finfine fariĝis granda artisto.	ep
El cuenco de cristal se rompió en trozos diminutos.	es
De dokter haastte zich naar zijn patiënt.	nl
你看起來很高興。	zh
Li ĉiam agordas siajn samklasanojn unu kontraŭ la alia.	ep
Die Ausnahme zu der Regel heißt Schwangerschaft.	de
Ese libro tenía muchas páginas.	es
Elle a totalement perdu le peu d'argent qu'elle avait.	fr
Bütün gökyüzü aydınlandı,bir patlama vardı.	tr
Polscy archeolodzy prowadzą badania w Afryce.	pl
¡Qué irresponsable!	es
Ela o adora.	pt
Ella se sentó cerca de él y le escuchó en silencio.	es
Estoy con dolor de dientes.	es
Nous sommes accoutumés à la vie dans une grande ville.	fr
Mode ist nicht mein Fachgebiet.	de
A bandeira do Brasil contém 27 estrelas.	pt
Ella se echó atrás cuando vio la serpiente.	es
Tom noticed Mary the moment she entered the room.	en
Tom is going to visit Mary tomorrow.	en
Mary is a single mom.	en
Quiero verte antes de irme.	es
Los musulmanes se adhieren a las enseñanzas del profeta Mohammed.	es
Sanal bellek çoklu görev çekirdekleri için geliştirilmiş bir bellek yönetim tekniğidir.	tr
Tom thinks he knows why Mary decided to become a nun.	en
La pentristo uzas nur mortajn kolorojn en siaj pentraĵoj.	ep
她丈夫去世時，她想自殺。	zh
Pour ce qui concerne le vin de qualité, aucun pays ne peut égaler la France.	fr
I've never met anyone who doesn't like chocolate.	en
La vivo en urbeto estas teda.	ep
Tom está acostumbrado a trabajar en exteriores.	es
Bunun ne olduğunu bana söyler misin?	tr
Hacía calor en la habitación.	es
Pour une raison quelconque, les gens m'ont évitée comme la peste depuis que je suis revenue d'Inde.	fr
É culpa sua eu querer ir.	pt
¡Entendí casi todo!	es
Tom klarigis kiel estus la embusko.	ep
Er hat die absolute Macht.	de
El río desemboca en el Mar de Japón.	es
It's just the opposite.	en
Bitte lesen Sie dieses Buch!	de
Bücher mehren die Freuden des Lebens.	de
Você deveria tirar o seu abrigo.	pt
He knows me well.	en
这场灾祸的恐怖，在记忆中慢慢消退。	zh
Том ждал тебя.	ru
Çocuklarını okula yolcu etti.	tr
Avez-vous une quelconque idée à l'heure actuelle ?	fr
Sie gehören nicht hierher.	de
Il medico mi ha ordinato di rimanere a letto.	it
Nur wenige wissen von dem Vorhaben.	de
Io dovevo cambiare il piano.	it
Is Tom there?	en
He made it clear that he had no intention of becoming a professional football player.	en
De bleka hundo ne venas vundo.	ep
El camino va paralelo al río.	es
C'est pas bien propre, tout ça...	fr
Mi esperas de vi seriozan laboron.	ep
Сотни людей работают на этом заводе.	ru
Look how happy Tom is.	en
Olyan kedves volt, hogy kölcsönadta az autóját nekem, amikor az enyém lerobbant.	hu
Ще дойдеш ли с нас?	bg
Mi ofte fiŝkaptas kun ili.	ep
Ein Postwagen ist ein Eisenbahnwagen, der Postsendungen befördert.	de
Die Italiener schlafen immer eine Stunde nach dem Mittagessen.	de
No quería irme sin decir adiós.	es
I was hunting.	en
Je ne parviens pas à croire qu'il vous ait embrassée.	fr
She's only had two boyfriends.	en
It's inhumane.	en
Li studas por fariĝi kuracisto.	ep
Они беспокоятся.	ru
Tom açıklayabilir.	tr
Ich liebe diese Zeit des Jahres.	de
Pourquoi es-tu venue ce matin ?	fr
Onlar çok samimi.	tr
Maria ŝajnis aŭskulti min atente kaj interesate.	ep
Despedi-me dela e saí constrangido.	pt
La homoj ĉirkaŭ la konstruaĵo vicatendis la malfermon de la teatro.	ep
Vi fartos bone ĉi tie.	ep
The problem is we don't have enough money to complete the project.	en
Are there any other problems that need taking care of?	en
Traktu la gepatrojn de via edzino kun respekto!	ep
Спасибо за твои добрые слова.	ru
Alles Erkennen ist ein Widerspiegeln in ganz bestimmten Formen, die von vornherein nicht existieren. Die Natur kennt keine Gestalt, keine Größe, sondern nur für ein Erkennendes treten die Dinge so groß und so klein auf.	de
You don't like to talk about your past that much, do you?	en
Bangunkan saya pada pukul delapan	in
Näin Tomin konsertissa neljä kertaa.	fi
Tom und Maria schlafen oben.	de
Non so cosa stava pensando Tom.	it
Quand est l'Apocalypse ?	fr
Dueco pli bonas ol soleco.	ep
Tom estaba preparado.	es
Lavamo-nos.	pt
What're you so nervous about?	en
Io sono sicura che lei è molto impegnata.	it
Калі б не сучасная медыцына, я б ужо быў мёртвы.	be
Non siete più bambine.	it
We appreciate the warning.	en
Someone's trying to get in.	en
Ich weiß, wie gefährlich Tom ist.	de
Li estingis la fajron, piedotretante ĝin.	ep
Kalbimi tamir olmamak üzere kırdın.	tr
Let's see if anybody's home.	en
Tom has always looked after his cars fastidiously.	en
Ik zal erop letten dat u een salarisverhoging krijgt na het eerste jaar.	nl
L'ho trovato nei vecchi avvisi.	it
Esperanto ŝanĝas la problemon, ĉar oni povas lerni Esperanton same bone kiel sian gepatran lingvon, kaj eble eĉ pli bone.	ep
Minkäkin halusin tavata sinut.	fi
Kion simbolas verda kandelo?	ep
Не потеряй.	ru
Neniu ofendiĝis.	ep
Het spijt me maar ik kan niet gaan.	nl
Il y a un cookie qui est tombé sous la table.	fr
Ĉu vi volas esti apud Tomo?	ep
Is the drawing quite explanatory?	en
Katso taaksesi!	fi
Édességet vettem és megettem.	hu
Questa è la volta buona.	it
Tom is extremely naive.	en
Onun babası haftada iki kez orada yemek yer.	tr
Você já quebrou um osso?	pt
Todo mundo se assustou.	pt
Aladino trovis magian lampon.	ep
Obwohl ich 2 Jahre Chinesisch studiert habe, gibt es noch viele Wörter die ich nicht kenne.	de
Milego poranka!	pl
Do you think I should go talk to Tom?	en
Je te verserai l'argent.	fr
Mais pourquoi souris-tu comme ça ?	fr
En son ne zaman birisinin elini tuttun?	tr
Lo sa come si chiamano?	it
Das ist eine phantastische Idee!	de
Tom tek başına orada yaşadı.	tr
I was glad to see my old friends.	en
Tom told me where he had hidden the old coins.	en
Bunu yaptığın tarz yanlıştı.	tr
Wenn Länder nach den Worten benannt würden, welche man als erste hört, wenn man sich dorthin begibt, so müsste England den Namen „Verdammt noch mal!“ tragen.	de
What happened was predictable.	en
Esta es una pastilla para dormir muy fuerte.	es
Noi gesticolavamo.	it
Ihr werdet abwarten müssen.	de
माझं बाळ अगदी जोरात लात मारतं.	ma
अमेरिका जगातला सर्वात महान देश आहे.	ma
I'm sticking with him.	en
Tom has lived in Boston most of his life.	en
Questo si dà da fare.	it
Том интересовался самочувствием Мэри.	ru
Вот что мы нашли.	ru
Na pokładzie tego samolotu było 144 pasażerów i 6 członków załogi.	pl
Już byłem zmęczony.	pl
Возвращение прошло удивительно буднично.	ru
Onlara geç kalacağımızı söyledim.	tr
Are you on any medications?	en
Li iam mokis la mallongajn piedojn kaj malrapidan paŝon de sia oponanto.	ep
Да, это не для слабонервных.	ru
Кто сказал им это сделать?	ru
Bunun üstüne, yağmur yağmaya başlar.	tr
Почему Тома сегодня нет?	ru
Birbirlerini öpmeye başladılar.	tr
Como podemos evitar que isso volte a acontecer?	pt
Lui sta per cucinare per voi.	it
Matkalaukkuni katosi.	fi
Том навидуим не забележа дека Мери е таму.	mk
Fiça !	fr
Се надевам дека ќе се згоди нешто интересно.	mk
Tom'un saç fırçasını ödünç aldım.	tr
Ben şu anda akşam yemeği yiyorum.	tr
Yolda Tom'u alacağız.	tr
Почему ты её ненавидишь?	ru
Il habite à côté de moi.	fr
Все женщины одинаковые.	ru
¿A que lo he hecho yo?	es
Поскольку это название, думаю, можно просто его оставить как есть без какого-либо ущерба для перевода.	ru
Не можам да го убедам.	mk
Проблема в том, что у нас недостаточно денег, чтобы закончить проект.	ru
Смрдам ли?	mk
Men are more likely than women to turn to risky behaviour when depressed.	en
Мојот мајчин јазик е португалскиот.	mk
Wenn man Rauchern ihre Zigaretten nimmt, werden sie nervös und reizbar.	de
Не сака риби.	mk
Totta puhuakseni en rakasta häntä.	fi
La instruistino diris, ke ŝi ne scias la respondon al mia demando.	ep
Remember that you are dust.	en
Sono quattro corone, per piacere.	it
Köyümüzün önünden nehir geçiyor.	tr
Была ранняя весна, поэтому покупателей было не много.	ru
Tom had three sisters.	en
Was denkst du dir eigentlich?	de
Tom verimliydi.	tr
Ты когда-нибудь был в другой стране?	ru
Уйди с моего места!	ru
Origami, a arte de dobraduras de papel, é uma antiga e refinada expressão artística da cultura japonesa.	pt
"Сколько ты здесь уже живёшь?" - "На следующей неделе будет пять лет".	ru
Неужели обманет?	ru
Тому надо успеть на самолёт.	ru
Bir sürü insan Tom'u bekliyor.	tr
En la teatro estis prezentata: Ses semajnoj – ses dancoj.	ep
Onlara dikkatli olmalarını söyle.	tr
Он не менее мудр, чем его отец.	ru
O, onun kişisel görüşüydü.	tr
Myślę, że nie możemy ufać Tomowi.	pl
Bu gece akşam yemeğinde konuşacağız.	tr
Я сказал ей оставить меня в покое.	ru
Sono pronto per iniziare.	it
Centra entrepreno liveros la kurenton.	ep
Tomit sokszor befenyítették az iskolában.	hu
Ti vogliamo tra i nuovi membri!	it
Mi lenne, ha most lemondanék?	hu
As quatro estações são: primavera, verão, outono e inverno.	pt
Это светлячок.	ru
Veja, ele não é tão feio como aparece nos livros ilustrados.	pt
Bela Lugosi kont Dracula rolüyle ünlü oldu.	tr
Мне придётся открыть окно.	ru
Ich hab's nicht absichtlich tun wollen.	de
Mono ne falas el ĉielo.	ep
Zum Museum musst du diesen Bus nehmen.	de
Neden bize gerçeği söylemek istemiyorsun?	tr
Dinner is pretty much ready.	en
Сделав уроки, он стал смотреть телевизор.	ru
Tom perdió a su esposa hace siete años.	es
Толпа разразилась аплодисментами.	ru
Je t'ai attendue longtemps.	fr
Clique aqui para os detalhes.	pt
Mi laboris la tutan nokton ĝis la tempofino atribuita.	ep
Я живу в Европе.	ru
Jen estas mia koramikino, al kiu vi parolas.	ep
Vi devus prilaboregi vian francan lingvon antaŭ via vojaĝo al Marsejlo.	ep
Ben senin geleceğine sevindim.	tr
Tom gerçekten iyi bir yıl geçirdi.	tr
Tom uykulu gibi davrandı.	tr
Hieraŭ vespere mi forgesis reŝargi mian telefonon.	ep
Paper is white; carbon is black.	en
Том по-настоящему гордится Мэри.	ru
Şimdi her gün görmediğin bir şey var.	tr
Tom rákényszerült, hogy eladja a gazdaságát.	hu
Том поёт тенором.	ru
Remélem, Tomi is jön.	hu
Как прошли каникулы?	ru
Si sono scambiati le loro fotografie.	it
O zaten başarısızlıklarının üstesinden geldiğini söylüyor.	tr
La kosto de la ponto senmezure kreskis.	ep
Lui finge di non preoccuparsi per i soldi.	it
Non importa se lui sia d'accordo oppure no.	it
Eu mostrei o meu quarto para ela.	pt
У меня жирная кожа.	ru
Tu aurais pu tout gâcher.	fr
Man ska aldrig säga aldrig.	se
Необходимо провести баллистическую экспертизу.	ru
Necesas, ke vi adaptiĝu al la situacio.	ep
Yetti artık.	tr
Ella quiere probar la comida japonesa.	es
Tom est extrêmement étroit d'esprit.	fr
He stayed there the whole time.	en
Jól tartja magát az öreglány, pedig már nyolcvan felett jár.	hu
Odoras brulaĵe.	ep
Comme les scientifiques ne cessent de le dire, il n'y a ni bon ni mauvais dans aucune découverte scientifique.	fr
Your comic books are on the shelf.	en
I hope you will join us in the parade and march along the street.	en
My birthday is coming soon.	en
Frank's boss is extremely money hungry.	en
John left for France yesterday.	en
As I heard the story secondhand, I can't ascertain the truth of it.	en
The meaning of this sentence is ambiguous.	en
Je reviendrai quand tu seras libre.	fr
He has a lot of things to do.	en
He accelerated his car and overtook me.	en
Tu tinhas um bocado de tempo.	pt
Ça m'a pris plus d'un mois pour guérir de mon rhume.	fr
Mistök í prentun skyldi bent á undir eins.	is
Það líkist snjó, ekki satt?	is
Ölstofa er vinsæll samkomustaður þar sem drukkinn er bjór.	is
Disculpe. Quiero un libro. ¿Dónde está la librería?	es
Da ich tief geschlafen habe, geht es mir wieder sehr gut.	de
Göl çok derin.	tr
Mi havas neniun sekreton por vi.	ep
Dus er is geen enkel probleem?	nl
Li moviĝas mallerte.	ep
Я не надеюсь.	ru
Wenn du dich nicht beeilst, kommst du zu spät zur Schule.	de
We don't want them to decrease our paycheck.	en
We sued the insurance company because it violated the terms of our policy.	en
Mi pruntedonos al vi iun ajn libron, kiun mi havas, kondiĉe ke vi tenu ĝin pura.	ep
Mi malofte havas tempon por legi.	ep
Ты выглядишь скучающей.	ru
Mi trovis la libron hazarde.	ep
Dieser Fuchs da muss das Huhn getötet haben.	de
Nie rób ze mnie wariata.	pl
Ela visitou-me não no domingo, mas na segunda-feira.	pt
Enfatizó la importancia de la paz.	es
Он пробежал мимо, не заметив ее.	ru
Ĉiu kato havas sian propran personecon.	ep
Não chore, por favor.	pt
Agarrá un huevo de la heladera.	es
Escrevo chinês.	pt
Ei voi olla!	fi
O şimdi akşam yemeği yiyor.	tr
Era sempre accompagnato da sua moglie.	it
La familia es la unidad más importante de la sociedad.	es
Er versuchte, die Gefühle anderer nicht zu verletzen.	de
O yurtdışına gitti.	tr
È molto improbabile come cosa.	it
Dou-lhe licença de se ausentar, sob a condição de que você regresse depois de amanhã.	pt
Ŝi volas fariĝi simultana interpretistino.	ep
Li adiaŭis ŝin per kiso.	ep
Nos acabamos de quedar sin sal ni pimienta.	es
Ero solita andare in chiesa alla domenica.	it
Siyah kumaş ışık emer.	tr
Birdenbire onun yüzü soldu.	tr
你耳鸣吗？	zh
Lui non poteva più sopportare il dolore.	it
Voi siete in una band?	it
El trabajo es todo para mí.	es
Mi igos vin scii la veron, kiam konvenos la tempo.	ep
Mutasson egy másik példát.	hu
My wish has finally come true.	en
La sala de consultas del doctor se encuentra en el segundo piso.	es
Bu kitaplar bizimdir.	tr
Il passait son temps à écrire des livres et lorsque lui manquait l'inspiration, il lisait.	fr
Elmesélte nekem élettörténetét.	hu
Ĉi tio estas malnova arbaro de platanoj.	ep
Questa è la ragione per la quale non sono potuto venire ieri.	it
Ni provu tion!	ep
She has one cat.	en
Если мне снова придётся ехать в Киото, то это будет в четвёртый раз за этот год.	ru
Nuestra ciudad está libre de contaminación ambiental.	es
Essa parede mede 30 jardas de comprimento.	pt
Tengo un dolor de muelas muy fuerte.	es
Kiam mi malfermis la pordon, mi trovis lin dormantan.	ep
As irmãs se parecem.	pt
Bina tamamen yıkılmıştı.	tr
Désirez-vous boire un peu de thé ?	fr
Tu che cosa vuoi?	it
A futball a kedvenc sportom.	hu
Grimpe dans la voiture !	fr
A Tom no le gustaba Mary.	es
Die beiden Kandidaten liegen Kopf an Kopf.	de
Çok geç uyandım.	tr
很遗憾我无法接受您的邀请。	zh
Quiero saber qué puedo hacer.	es
You ought to decide whether or not you want to go.	en
Es war eine kostbare Uhr, die ihm seine im Krankenhaus befindliche Großmutter gab.	de
I'll tell my dad!	en
Sembri impaurito.	it
They're staring at Tom.	en
¿Conoce usted al Sr. Jackson?	es
Bald darauf kamen einige seltsam gekleidete Leute, die sich Landvermesser nannten, und sie vermaßen eine Strecke vor dem kleinen Haus meiner Großmutter.	de
Genieße diesen Tag und freue dich des Lebens!	de
Mir ist immer noch ganz schwindlig.	de
La decisione era inevitabile.	it
I wish I could speak French.	en
Yo sé tu secreto.	es
Ben isterken kimse yoktu yanımda, şimdi istemiyorum bütün kadınlar etrafımda.	tr
Ella tiene dientes blancos.	es
Ne parolu. Ili povus aŭdi nin.	ep
Tom didn't even notice Mary had left.	en
Você está tentando se aproveitar da situação.	pt
Zatrzymasz dziecko?	pl
Мне нужны цветные карандаши.	ru
Ереван - это столица Армении.	ru
Mi ankoraŭ neniam vidis NIFOn.	ep
Ŝajne li estis malriĉa dum sia junaĝo.	ep
Pare e pense nisso.	pt
Я подумал, что тебе нужны деньги.	ru
We just cleaned our room.	en
Llevan casados veinte años.	es
Dia lebih indah dariku.	in
Не мога да го направя сама.	bg
Is het duurder om gezond te eten?	nl
Nerous on vain yhden liikkeen päässä hulluudesta.	fi
Tom was married to a Canadian.	en
Sie hat uns alle lieb.	de
Lui è davvero ammalato.	it
Mi ĵus ricevis novan alvokon de li.	ep
Are we good to go?	en
Io sarò libero domenica prossima.	it
Das kann ein Problem sein.	de
Nous nous sommes couchés.	fr
Marie s'épuisait.	fr
La antaŭa luinto tre diligente prizorgis sian loĝejon.	ep
Laurie ist hübsch.	de
Lauseet opettavat meille paljon. Paljon enemmän kuin pelkät sanat.	fi
Qualcuno ha mangiato tutti i miei cupcake.	it
У него был ребёнок, хотя он и не был женат.	ru
Калі хлопцы кінулі асінае гняздо ў бок старой жабрачкі, яно ператварылася ў гаршок з залатымі манетамі.	be
Почему ты не послушал его совета?	ru
Mi alvokas vin, ĉar mi troviĝas en senelira situacio.	ep
Lei non poteva andare al matrimonio.	it
Ему не снятся кошмары.	ru
Bu konuda hiçbir sorun yok.	tr
Tom says he can't give me what I need.	en
Ti dispiace dirmi cosa sta succedendo?	it
Majdnem hatvan éves.	hu
तत्त्वज्ञान म्हणजे काय?	ma
As frutas-pão de qualidade inferior valem tanto como um coco, mas as melhores valem o equivalente a um octópode.	pt
The girls bought him a watch.	en
Mit írsz?	hu
Mi ne volas scii, kiu mi estas.	ep
Ho ricevuto una telefonata anonima.	it
Die meisten Märchen beginnen mit den Worten: „Es war einmal ...“	de
Quant'è ubriaco?	it
Tom hat uns viel von euch erzählt.	de
Позволь мне объяснить тебе это на пальцах.	ru
Tom is quite forgetful.	en
En ole laiska.	fi
Ez tényleg szép város.	hu
È sempre stata la sua vocazione?	it
Трудная работа никому еще не повредила.	ru
Kiom da tempo necesos al vi por tagmanĝi?	ep
Versprich mir einfach, dass du keine Dummheiten machen wirst.	de
Penso che Tom stia soltanto fingendo di dormire.	it
Itt foglak várni.	hu
Öfkeyle kalkan zararla oturur.	tr
That's why I've done all this.	en
Sembra che ci siano diverse ragioni per il suo fallimento.	it
La tua compagnia mi è gradita!	it
Han är en släkting till Adam.	se
I don't like cranberries.	en
Tom kızıyla çıkmama hiç karşı çıkmadı.	tr
Avete mai visto la persona in questa foto?	it
Jag träffar honom emellanåt.	se
Sen çok iyi birisin.	tr
Be nice to him.	en
Don't you dare ask him that.	en
Dan fled to Mexico.	en
Как сте?	bg
Gönüllü olmadığımı nasıl biliyorsun?	tr
Tom benim için çalışıyor.	tr
Yapabiliyorsan bana yardım etmelisin.	tr
Uşaqlar bəzən qaranlıqdan qorxurlar.	az
É carne de porco ou nada.	pt
Are you marrying him for his money?	en
Tom almost died today.	en
Onlarla konuşmamıza izin verin.	tr
Endişe etmek enerji kaybıdır.	tr
Multaj insektoj, kiuj havis sian delikatan koloron de senkulpaj folioj kaj herboj, en tiu tago nove koloriĝis de mortantaj homoj kaj lasis per sia rapidega forkuro nenaturan postesignon.	ep
Ik zal u nooit beliegen.	nl
Az biztos, hogy ez nem gyilkossági kísérlet volt.	hu
Ова е саботажа.	mk
Tegyen egy sétát a ligetben.	hu
Er verschränkte die Arme vor der Brust.	de
Томас, потруди се малку!	mk
Egyedül fogom megvenni!	hu
Дан ни дојде во посета вчера.	mk
Том ѕуреше во документот.	mk
O cristianismo nos manda perdoar nossos inimigos, amar o nosso próximo.	pt
Il y a beaucoup de chiens ici, n'est-ce pas ?	fr
Градот беше оштетен за време на војната.	mk
Черепица, упавшая с крыши, разбилась вдребезги.	ru
Jag tror att jag satt på den.	se
Tom jobbar på bilverkstaden.	se
Dein Problem ist, dass du leicht ablenkbar bist.	de
Это я ослеп.	ru
Nagyon jól tudod, hogy miről beszélek.	hu
У нее были глаза цвета цветной капусты.	ru
Mun bändi soittaa tänä yönä.	fi
Benim için asla zamanın yok.	tr
I believe you've dialed the wrong number.	en
Ноги в колготках телесного цвета больше похожи на сосиски в упаковке.	ru
Ik zou zo graag de moed hebben aan die vrouw die mijn haren knipt te kunnen zeggen dat ik niet van die pony hou.	nl
Gli errori capitano davvero.	it
Körbejárta a hegyet.	hu
Esta trilha conduz ao jardim do paraíso.	pt
Beni arabayla hastaneye götürdü.	tr
Ela fica na internet tempo demais.	pt
La conozco desde que ella era un bebé.	es
Тебе придется сказать Тому самому.	ru
Он строил больницы и помогал людям Африки улучшить свою жизнь.	ru
很高兴你是对的。	zh
Mi venis hejmen kun malplenaj manoj.	ep
I giovani di oggi spesso non li capisco.	it
Tom has committed a serious crime.	en
Il camino è fatto di mattoni.	it
Я дам им знать, что ты здесь.	ru
Do you know how many millionaires live in Boston?	en
Eu não matei Tom.	pt
Шепни мне на ухо, Мэри.	ru
Ĉu vi scias, kial Tomo hodiaŭ venis ĉi tien?	ep
Tom onu yapması için Mary'yi nasıl ikna etti?	tr
Tom hat Angina.	de
La panejo situas apud la viandejo.	ep
Tom ve Mary bankta yer değiştirdi.	tr
Концерт проходит раз в год в Лионе.	ru
Harika yaptığımızı düşünüyorum.	tr
Yeni restoran geçen hafta açıldı.	tr
Kendime yeni bir bisiklet almak için param yok.	tr
Все знают, что ты лжёшь.	ru
May I ask your age?	en
Mary altın küpelerini taktı.	tr
Ничего мне не покупай.	ru
¡Eso fue demasiado cuchi!	es
Человек не властен над своей судьбой.	ru
Tudtam, hogy nem kellene meglátogatnom, mégis így tettem.	hu
Keşke Tom kararını verse.	tr
Precize tiel tio okazis.	ep
Bob harika bir adam.	tr
Io provo ancora ad essere prudente.	it
Арендная плата очень высока.	ru
Alo, burası oda servisi.	tr
Onun hepsinin olduğu yer burası.	tr
Unter einer Leiter durchzugehen, bringt Unglück.	de
Cosa stanno guardando tutti?	it
Мою сестру обрюхатил какой-то женатый мужик, который не собирается бросать жену ради неё.	ru
Этот вопрос я и сам себе задавал.	ru
Tri aliaj soldatoj estis pafvunditaj.	ep
Le relazioni sopravvissute alla lontananza sono ricompensate per l'eternità.	it
Вы не пожалеете, что взяли меня на работу.	ru
Ей страшно, когда она одна.	ru
Ero troppo spaventata per fare qualunque cosa.	it
La servistoj koliziis kaj lasis fali siajn pletojn.	ep
Tomi egy hallgatag fiú.	hu
Kial ni ne povas tion fari?	ep
Tomo havas filinon.	ep
Период функции косинуса составляет 2π.	ru
Quel floppy si è smagnetizzato?	it
Видишь?	ru
Finfine estas ĉiam mi la kulpinto, ĉu ne?	ep
Ich habe wirklich nicht viel Zeit.	de
Bugün yeni bir şey keşfettiniz mi?	tr
The boss said this group is a real mixed bag. I wonder if he places me with the wheat or the chaff.	en
The man robbed Susan of all her money.	en
It was impossible for me not to think of incident.	en
No sooner had I entered the hall than the ceremony began.	en
Can you tell me the art of recognizing matsutake mushrooms?	en
Who are you referring to?	en
Ça ne fera aucune différence.	fr
Eu acabei de chegar aqui.	pt
All men are mortal, all Greeks are men, therefore all Greeks are mortal.	en
On mieszka dwa domy od nas.	pl
Das Risiko ist zu groß.	de
Dobrze. Żadnych nieobecnych.	pl
Regardless what you may do, the outcome will still be the same.	en
Es hört nicht auf, zu bluten.	de
Kiom vi pagis por ĝi?	ep
Sa mère avait honte de lui.	fr
Ils vont réduire leurs dépenses.	fr
Abelpikoj povas esti tre dolorigaj.	ep
Quelle heure te conviendrait ?	fr
Hast du je mit ihm gesprochen?	de
Via filo preskaŭ estas kopiaĵo de la patro.	ep
Ik zal voor je duimen.	nl
Þeir eru glaðir sem gleyma öllu.	is
L’homme n’est jamais ni parfait, ni content.	fr
Ég get ekki unnið núna.	is
Ĉi tiu tranĉilo ne tranĉos bone.	ep
A király miden szerdán bíráskodott.	hu
Mi már nem tudunk gépek nélkül élni.	hu
Li fariĝis orfo kiam li estis dekjara.	ep
Tijdens deze droogte zijn veel boeren gestorven.	nl
Przed wyjściem proszę się upewnić, że światło jest wyłączone.	pl
Nic nie może zastąpić czasu.	pl
I know that you know that I know.	en
Ég veit ekki hvað ég á að gera núna.	is
Ŝi montris siajn talentojn.	ep
He resigned and joined the army.	en
Não posso te ajudar.	pt
Aún no ha nacido quien se pueda creer eso.	es
Она говорит по-русски.	ru
Es-tu esseulée ?	fr
A szép kémnő hidegen végigmért engem.	hu
Leben wie Gott in Frankreich.	de
Y una vez al mes, con la cara compunjida, tenía que pasarse por la comisaría, pagando así por un delito que nunca cometió.	es
Wir helfen Ihnen gerne.	de
Sa capacité de réflexion logique est à chier.	fr
Não consigo abrir minha caixa de mensagens.	pt
Consertou meu guarda-chuva.	pt
Elle était l'organisatrice de la rencontre.	fr
Это ваш ребенок разорвал мою книжку на кусочки.	ru
La pordo ne fermiĝas.	ep
Diğer bir deyişle, doğal bir sıcaklık olmadığı sürece, güvenilirlik mümkün değildir.	tr
Özel işlere karışmayın.	tr
Profite de la vie, car lorsqu'on est mort c'est pour longtemps, vraiment longtemps.	fr
Я знаю хороший итальянский ресторан.	ru
What kind of music does Tom listen to?	en
Li prezentas la cirkonstancaron tro nigre.	ep
Ĝis revido, venu ofte!	ep
Bir içki için dışarı çıkmayı öneriyorum.	tr
Sai che cosa vuol dire AMP?	it
Tom ve Mary birbirleriyle İngilizce konuşuyorlar.	tr
Posso prestarle un po' di soldi se vuole.	it
Mi tro mallaboremas por plenumi mian taskon.	ep
¿Estás pensando seriamente en divorciarte?	es
Auf dem Matschboden ist der Ackerwagen bis zum Achsnagel eingesunken.	de
Tom a consenti à être là à 2:30, mais il ne l'est pas encore.	fr
Deveria chover hoje, não?	pt
Bu veri benim tezim içindir.	tr
Nunmomente mi estas sen laborposteno.	ep
Der Konvent ist nicht einfach eine Vorbereitungsphase wie seine Vorgänger. Es sind sehr wichtige politische Gleichgewichte und Übereinkommen erreicht worden, und diese müssen erhalten bleiben. Darum sind die Regierungschefs verpflichtet, eine wesentlich bessere Arbeit zu leisten. Die Verantwortung, die sie tragen, ist somit viel größer.	de
Soha többé nem tud járni.	hu
If I set the language to "French (Canada)," then it comes out as "courriel;" but if I set it to "French (France)," it appears as "e-mail."	en
Ihr gebt hier keine Befehle.	de
Anche se trafficata, Rio è una bella città, purché ci si guardi le spalle.	it
Kiam li atingis la stacidomon, la trajno jam preskaŭ horduonon foriris.	ep
Es war für den Jungen unmöglich, über den Fluss zu schwimmen.	de
Nous devons faire attention à nos dépenses.	fr
Alguém nos seguiu até aqui?	pt
Vous auriez sa petite sœur ?	fr
Christmas is just two weeks away.	en
La kredo ne estas la komenco, sed la ĉeso de ĉiu scio.	ep
We are alluding to war.	en
Ŝi estis ĉantaĝita de li.	ep
Tom war wütend auf Maria, weil diese auf seinem Platz geparkt hatte.	de
Çocuk kasabayı geziniyordu.	tr
Идём на посадку.	ru
Wir eilen, durch unsre zeit’ge Warnung ein Komplott, das wider Sie gespielt wird, zu entkräften.	de
Kie estas Mary?	ep
Мы жили в дешёвой гостинице.	ru
Some day, you will see me.	en
Würden Sie mich zu meinem Hotel fahren?	de
В Организации Объединенных Наций они открыто выступают против всех миролюбивых предложений Советского Союза.	ru
Ich kann dein Verhalten nicht unterstützen.	de
Tom isst für gewöhnlich zu schnell.	de
Deine Freunde sagen dir, es geht vorbei. Aber es geht nicht so leicht.	de
Quella di Roma è una dominazione imposta.	it
Mon franc est tombé.	fr
Il est arrivé là-bas avant vous.	fr
Once he got a taste, you couldn't keep him away from it.	en
Ŝi vere dungiĝis kiel volontulino.	ep
Ĉio detruiĝas.	ep
Después de acabar los deberes, leí un libro.	es
Tú también has invitado a tus amigos, ¿verdad?	es
Ich glaube nicht, dass er aufrichtig ist.	de
Het kan moeilijk zijn om een appartement te vinden.	nl
Silence ! Je ne tolérerai pas ton insolence !	fr
Él se gana la vida tocando el piano.	es
Le nostre scorte stanno finendo.	it
Li enhejmiĝis komence en Nord-Ameriko, poste en Francio.	ep
Er fühlte sich ausgenutzt.	de
Mi scias, kion ili diris.	ep
Potreste incontrare Tom.	it
Elles volaient.	fr
Ele cometeu um crime grave.	pt
Defol dedim!	tr
Niçin Fransızcan çok iyi.	tr
Tom burada çalışmıyor.	tr
Welcome to Wikipedia, the free encyclopedia that anyone can edit.	en
Das war für sie eine zu schwierige Aufgabe.	de
Vous aimez la pluie et la neige.	fr
I'm sure Tom will wish he hadn't done that.	en
Tom thought that was a bad idea.	en
Zwanzigmal setzte ich mein Leben, sogar meine Ehre aufs Spiel ... aber meine Freiheit verkaufe ich nicht.	de
Tom'u dışarı atın.	tr
ती झोपून गेली होती.	ma
Ĉu vi pensas, ke mi volas tion?	ep
Does Tom look like he's happy?	en
Donu al mi ŝtrumpetojn, miaj piedoj malvarmiĝas.	ep
Mettete più sale nella minestra.	it
Meg tudná nekem mutatni a kikötőbe vezető utat?	hu
Io voglio ringraziarvi per quello.	it
Tom non c'era nemmeno.	it
Combien de sacs avais-tu ?	fr
No lo entiendo tampoco.	es
Он меня ошеломил.	ru
Ce hall était plein de monde.	fr
Gebt jedem der Kinder drei Stück.	de
Lei era buona a nulla.	it
Onu yapmamanı istedik.	tr
Что ты знаешь об этом месте?	ru
Ni fermis la butikon.	ep
Onun hepsi orada mı?	tr
Tio funkcias nur per Vindozo.	ep
O çok güzel bir kız.	tr
I was able to get a teaching job in Boston.	en
Lo so che sei occupato.	it
Sen iyi bir oyuncusun.	tr
I wish I had someone to tell all my secrets to.	en
मी नौदलात गेलो.	ma
She hid her burning cheeks in the bosom of the young man.	en
Сложих го в стаята ти.	bg
Onko asia oikeasti tällä järjestyksessä? Sujuu hyvin?	fi
Sembravate sorpresi.	it
Noi abbiamo adottato una bambina.	it
Vi ne ĉiam povos kaŝi vin al mi.	ep
Questa satira fa riflettere.	it
Olkaa niin kiltti ja antakaa minun jäädä.	fi
Tom said he knew I was coming.	en
Athen liegt in Griechenland.	de
L'asse è rotta.	it
Sur ĉiu flanko nur manko kaj manko.	ep
Crying won't solve anything.	en
Мы ещё совсем не обсуждали эту тему сегодня вечером.	ru
Je pense qu'elle a quelque chose à cacher.	fr
Niemand wich zurück.	de
E atrelou ao trenó o cavalo, seu cavalo cor de sangue.	pt
O benim son şansımdı.	tr
İyi ki o arabayı satın almadım.	tr
E se cominciassero a sbattere fuori chi non ha i requisiti per avere le case popolari?	it
Mi pardonpetas, mi ne intencis mordi vin.	ep
So gebet dem Kaiser, was des Kaisers ist, und Gott, was Gottes ist.	de
Я веду репортаж из твоего пукана: здесь всё пылает!	ru
Nós fazemos um time excelente.	pt
Daha fazla bilgi için web sitemizi ziyaret edin.	tr
Tam 12'den vurdun.	tr
Я жил в Токио с 1985.	ru
我把我的鞋放在床下。	zh
No juuri siksi minä kielsin sinua menemästä autolla.	fi
Kendine yeni bir bisiklet aldığını görüyorum.	tr
Bahçemize güller diken kişi Tom'du.	tr
Did you hear all that?	en
Gözlerini sil.	tr
Non essere impaziente, i tempi stanno cambiando.	it
Tom's not asleep.	en
Non li tocco.	it
Bu o kadar korkutucu değil.	tr
I helped them weed the garden.	en
Мен малко ме боли гърлото.	bg
У этого языка простое письмо и лёгкое произношение, но адски сложная грамматика.	ru
Tarot kártyából jósoltak apámnak.	hu
Ben je nu moe?	nl
Sana gerçekten ne oldu?	tr
Nagyjából korombeli.	hu
Брат, згодна е!	mk
Elles vont sauter.	fr
Ова може да предизвика и рак на белите дробови.	mk
Ты не будешь там счастлива.	ru
Я должен отправиться в Нью-Йорк на следующей неделе.	ru
Том ещё не читал отчёт, который ты составил.	ru
Miért lennék féltékeny?	hu
Kumanda arıyordum.	tr
Tom sembra matto.	it
Eravate sullo stesso aereo.	it
Dovete essere molto orgogliose.	it
Bu, çocuklar için bir yer değil.	tr
Одникаде се појави.	mk
Még egyszer elmosogatok.	hu
Не можеме да му се спротивставиме на ова.	mk
Första gången är gratis.	se
Aslında, bu bir hata.	tr
O, düşündüğün gibi iğrenç adam değil.	tr
This dish is eaten without bread.	en
Sadece orada durma, bir şey söyle.	tr
Sono un elettricista.	it
Hoy cumplo veinticinco primaveras.	es
Ты так и не сказал мне, кто ты такой.	ru
Это вопрос, на который никто не знает ответа.	ru
Összeállítanál nekem egy listát erről?	hu
Всему виной дождь.	ru
Пожалуйста, не стесняйтесь поправлять меня, когда я говорю по-французски.	ru
Necesito encontrar mi lapicera.	es
Kion ŝi ja pensis pri tio?	ep
Eu quero ouvir a estória toda.	pt
Wang Xiaoming İngilizce konuşuyor ama çok İngilizce kitabı yok.	tr
Tom dovette accendere un fuoco.	it
Mi può dire quale pulsante premere?	it
Как продвигается следствие?	ru
Ein Sanitäter hob den bewusstlosen Mann auf.	de
Notre chien enterre des os dans le jardin.	fr
Ik ben niet rijk genoeg.	nl
Нам не хочется пить.	ru
Tomo similas sian patron.	ep
Não se irrite; eu só estava perguntando.	pt
Which side are you on?	en
Bu kadar şiddetli ağrıyı nasıl görmezden gelebilirim?	tr
Том три года жил за границей.	ru
Том много ругается.	ru
Geçen gün beyzbol oynamak için parka gittim.	tr
La foto sui social è importantissima.	it
Eles vêm do mesmo vilarejo.	pt
Раз погода хорошая, можно я окно открою?	ru
Ben jij 's avonds altijd thuis?	nl
Fransa'da benzin Amerika Birleşik Devletleri'nden daha pahalıdır.	tr
Kion ceteran Tomo volis?	ep
Kian vi trinkas, blankan aŭ ruĝan?	ep
Mi bone scias la usonan historion.	ep
Ты ведь понятия не имеешь, где мы?	ru
Вчера индекс котировки акций упал на 200 пунктов.	ru
Will you still be here when I come back?	en
Tom nem beszél franciául.	hu
Gizem çözülmemiş kalıyor.	tr
Quando a primavera chegou, a neve derreteu.	pt
Bu tür düşüncelerin sonuçta onların nihai kararı üzerinde herhangi bir etkisi olmamıştır.	tr
Bunun gerçek olduğunu biliyorum.	tr
Tom planını gerçekleştirdi.	tr
Я приехала в Бостон три месяца назад.	ru
Annen muhtemelen sizin dağa tırmanışınıza itiraz edecektir.	tr
Sarei disposto ad aiutarla.	it
Он воспользовался возможностью взять слово.	ru
Я могла спасти Тому жизнь.	ru
Jesteś nieszczery.	pl
Не давай Тому плавать.	ru
Я была совершенно шокирована.	ru
Schaue nicht fern!	de
Bu bizim son vedalaştığımız park.	tr
They're getting married.	en
Почекай тут.	ua
I regret singing that song at Tom and Mary's wedding.	en
Puffed sleeves are so fashionable now.	en
Même les gens qui ne croient pas en l'église catholique vénèrent le Pape comme un leader symbolique.	fr
Do you have any light beer?	en
You're playing with fire if you insist on riding your motorcycle without a helmet on.	en
Hello, I'm Tomoko Sato from Japan.	en
Because she is a wonderful teacher.	en
Oh, but he did come to Tokyo alone.	en
It's beyond me.	en
The orange appears rotten inside.	en
Christmas is a good time to market new toys.	en
反対投票多数。	jp
Elle sera une artiste célèbre dans le futur.	fr
My new book is not yet in print.	en
A good sweat will cure a cold.	en
I will pay my debt as soon as possible.	en
He has a slightly foreign appearance.	en
He went down the hill.	en
He took me for an Englishman.	en
Get the dream.	en
Ella está entusiasmada tejiendo.	es
我挣扎着挤出地铁。	zh
Poparzył sobie język gorącą herbatą.	pl
Sie war sehr stolz auf ihren Vater.	de
Er spart Geld für eine Überseereise.	de
Quanto è alto?	it
«Возлюби ближнего, как самого себя», — это цитата из Библии.	ru
Студенты должны регулярно посещать занятия.	ru
Ci sono molti libri, non trovi?	it
今天即使再忙，也要做完这些事情才走。	zh
Je suis sûr que c'est quelqu'un de compétent.	fr
Ik woon in deze wijk.	nl
El niño de escondió tras la puerta.	es
My older brother knows how to drive.	en
Li riparis al mi la horloĝon.	ep
J'ai remarqué quand tu es entré dans ma chambre.	fr
Des mots, des mots...	fr
Мы пойдём, когда кончится дождь.	ru
Mortinta hundo ne povas mordi.	ep
Er bot spontan seine Hilfe an.	de
Ciò è anche abbastanza breve.	it
Maĉi kaj remaĉi.	ep
Je ne peux pas acheter de pièces de rechange pour cette voiture.	fr
Toms Flug wurde um drei Stunden verschoben.	de
Le sourire du monstre était cruel.	fr
Mia edzino ĉi-momente preparantas la manĝon.	ep
É difícil encontrar um emprego permanente que pague bem.	pt
Perché "desueto" è un termine desueto?	it
A szabályok módosítását javasolta.	hu
Sur muro pendis la portreto de la prezidanto.	ep
Tiu ĉi estas la restoracio, kie mi kutime manĝas.	ep
Bon, sa silhouette est superbe et sa figure...elle peut toujours la voiler.	fr
Mimo wszystko uważam, że raczej dziś nie przyjdzie.	pl
Hace calor en esta sala.	es
Tom asked Mary how she had lost so much weight.	en
No livro, o personagem principal é capaz de metamorfosear-se.	pt
Tom topluluk önünde konuşmayı sevmiyor.	tr
I need some nutmeg.	en
Du könntest genauso gut einen Roman lesen, anstatt nur Löcher in die Luft zu starren.	de
O tráfego em São Paulo é intenso.	pt
Je sursautai de surprise.	fr
Barnet slutade gråta.	se
Мне не хотелось бы его встретить в тёмном месте.	ru
Voy camino al teatro en la esquina.	es
Мне нужна виза для въезда в страну.	ru
Sadece birkaç kişi onu dinledi.	tr
Sir Winston Churchill, büyük bir devlet adamı olmanın yanı sıra, büyük bir yazardı.	tr
Kırk kişi katıldı.	tr
Obudziłem się na kanapie.	pl
Der Hund folgte der Straße.	de
Er is bijna geen koffie over in de pot.	nl
У него есть достаточно денег, чтоб это купить.	ru
Ouvrez votre livre à la page dix.	fr
Sarete utili a voi stessi e agli altri!	it
Gelecek hafta iki gün izin alacağım.	tr
Человек сидел на поваленном дереве.	ru
Договор действует до полного выполнения сторонами своих обязательств по настоящему договору.	ru
Ich kann gar nicht sagen, wie dankbar ich Ihnen für Ihre Hilfe bin.	de
В данный момент я живу в Куньмине.	ru
Is that car too small?	en
A szomszédom, de nem nagyon ismerem.	hu
Okazis, ke homoj dormantaj kun enŝaltita ventolilo spertis kvazaŭ frostiĝon de la stomako, kaj ankaŭ lokan aerpreman streĉiĝon, kiu igis ilin senti sin malsanaj.	ep
Мы похороним вас.	ru
Jeg gik ind i tunnelen.	dk
A százméteres versenyfutást ő nyerte meg.	hu
Du kannst nicht ohne Wasser leben.	de
They anger us with their behavior.	en
Je tente de te parler.	fr
Relâchez-le !	fr
Bonvenon ĉe la longa vesperfesto pri vino kaj fromaĝo.	ep
Mio padre ha già smesso di bere e di fumare.	it
Un extraño se puso a hablarme.	es
La vortoprovizo de iu lingvo en iu epoko spegulas la materian kaj spiritan kulturon de ĝiaj uzantoj.	ep
Bazen içecek çok fazla şey ancak yeterlidir.	tr
Tokyo Japonya'daki bütün şehirlerden daha büyüktür.	tr
Elimden gelse, uçakla gitmek istemiyorum.	tr
Merdivenlerden yukarıya koştuktan sonra nefes nefese kaldım.	tr
Tom verlor all sein Geld.	de
Бетти говорит так, как будто всё знает.	ru
O korkmuyor.	tr
Mi ne volas fari tion kun vi.	ep
她有很强的个性。	zh
Tom pensó que podría ganar mucho dinero en la bolsa.	es
Elles abîmeront leurs vêtements.	fr
Kutija je bila puna knjiga.	hr
No fume en ayunas.	es
Деньги - это не главное в жизни.	ru
Я не очень голоден.	ru
Ili ŝatos tiun ludon.	ep
Je suis fatigué de leurs continuelles demandes.	fr
Li igis min fari ĝin.	ep
Il n'y a guère que cette andouille pour croire une chose pareille.	fr
Ha solo due anni in meno di me.	it
Polis sadece parayı alacak ve belki de sahibini aramayacaklar bile.	tr
Hoy el mundo se está uniformizando.	es
Um mês é muito pouco tempo.	pt
Вы изучаете французский, не так ли?	ru
Andrò ad Atene.	it
Полный бак, пожалуйста.	ru
You've got to come out now.	en
Paciência tem limites.	pt
Я рада видеть тебя счастливым.	ru
You'll have to be more specific.	en
Keep that to yourself.	en
Tom started talking to his girlfriend about breaking up.	en
Я ничего не имею против.	ru
Осуществление права на свободу совести не должно обуславливать или ограничивать общечеловеческие и гражданские права и обязанности перед государством.	ru
John Quincy Adams alparolis la homamason.	ep
Não há nada tão difícil que se não possa estudar.	pt
Mi kredas, ke ja estas tute kontentige havi nin, viroj: alian odoron, alian korpon, alian voĉon, la iluzion havi protektanton.	ep
How often does Tom come here?	en
Wir mussten uns um sieben Uhr hier treffen.	de
Я не могу забыть о том, что произошло.	ru
Sarete sempre i benvenuti qui.	it
Prima ci avvelenano e poi vanno in aula a fare le passerelle.	it
But I do like that, mortals.	en
Yapacak küçük bir duyurum var.	tr
Le macchine si ribellano.	it
Lia politiko estis progresema.	ep
У Тома борода длиннее, чем у Джона.	ru
İncinmekten korkar mısın?	tr
Kial vi asertas ne koni min?	ep
Não sei onde fica.	pt
Valamikor szeretnék ellátogatni Angliába.	hu
Bilmek istediğin bir şey var mı?	tr
Pensavamo lo sapessi.	it
Ils construisent, à côté, un immeuble qui nous gâchera la vue.	fr
Tom ne intencas resti.	ep
«Ну кто так делает?! Руки бы оторвать!» – «Ага. И голову заодно».	ru
Avez-vous un livre au sujet de la Deuxième Guerre Mondiale ?	fr
On va où demain ?	fr
Gold war in Japan einst weniger wert als Silber.	de
¿A dónde se fue?	es
Mi passi quel giravite piccolo.	it
Tom önümde oturdu.	tr
C'est là que se trouve ma chaîne stéréo.	fr
La tegmento brilas subsune.	ep
Soy celoso.	es
Vorremmo il gelato al fuoco e della frutta caramellata, solo mele e banane.	it
Le constat du grand linguiste Claude Hagège est sans appel : jamais, dans l'histoire de l'humanité, une langue n'a été « comparable en extension dans le monde à ce qu'est aujourd'hui l'anglais ».	fr
Tom is very shallow, isn't he?	en
Io ho ucciso i topi.	it
Ó Istenem, segíts!	hu
Mitunter macht sogar ein Genie einen Fehler.	de
Mi ne kondutis tute honeste kontraŭ vi.	ep
Yazılım seks gibidir: parasız olunca daha iyidir.	tr
Ele aprenderá os fatos com o passar do tempo.	pt
Директор орал на своего работника.	ru
Ma taci che è meglio!	it
Pourquoi vous intéressez-vous à moi ?	fr
La venĝo estos senkompata.	ep
Banka kapalı.	tr
Zelfs Tom glimlachte.	nl
Ik ken de waarheid.	nl
Tom zjada wszystko, co Mary przed nim postawi.	pl
Mi estas tiom stulta esti farinta tian aferon!	ep
Cette vallée est très fertile.	fr
Мне очень нравятся блюда китайской кухни.	ru
Verranno pagati bene.	it
Mary hakkında görerek öğreneceğin bir şey var.	tr
Tom ya tiene un plan.	es
Tom bu önümüzdeki hafta Mary'yi görmeye can atıyor.	tr
Elkísérlek benneteket az állomásra.	hu
Bütün faturaları ödeyen benim.	tr
Vi fa comodo sentire ciò che volete sentire!	it
Why did I have to be here?	en
Tom è generoso.	it
Você joga golfe?	pt
Моё сердце разбито.	ru
Me l'ha promesso.	it
Mi kutimis bicikli al la lernejo, sed nun mi uzas la buson.	ep
Tom'un pasaportunu gördün mü?	tr
Tom şaşırmış olmalı.	tr
Maybe it's time to tell them.	en
Why should I tell them?	en
Tomun ötən gecə nə etdiyini bilirsən?	az
Ismered az embert, akinek a háza előtt most mentünk el?	hu
Gözlerimin dolduğunu hissettim.	tr
Вы знаете, что я думаю.	ru
War es interessant?	de
Bu valizleri nereye koymamı istiyorsun?	tr
Tom on üç yaşındayken dalmayı öğrendi.	tr
Не требаше да платам толку за ова.	mk
A molnár a malomban dolgozik.	hu
Biztos vagy ebben?	hu
Vai a trovarlo.	it
Не ти барам да одиш на љубовен состанок со Том.	mk
Ezt mind a ketten elismerték.	hu
Már megint lövöldöznek a városban.	hu
Ĉu vi scias, kiel veturigi aŭton?	ep
Naponta többször belenézek a tükörbe.	hu
Градот беше изграден одново по војната.	mk
Каде сакаш да бидам?	mk
Не ни имав прилика да побарам помош од Том.	mk
Том немаше да стигне на време да не трчаше.	mk
Што дрдори Том?	mk
Das Problem wird sich schließlich lösen.	de
Ќе одам до веце.	mk
Вода нема.	mk
Сите ќе бидат во ред.	mk
Tom escucha.	es
Hareket edelim.	tr
Pár hete találkoztam Tomival.	hu
Anaís är ett vackert kvinnonamn av grekiskt ursprung.	se
Тигра було вбито.	ua
Thirteen people are injured.	en
Erkek kardeşim bir profesör.	tr
Ele não foi porque estava doente.	pt
Anya mellettünk lakik.	hu
Onu yapmayı isteyeceğimi sanmıyorum.	tr
Bize bir şey aldın mı?	tr
Beni rahatsız etmeyi bırak. Ben meşgulüm.	tr
Mary talked with her friends about it.	en
Том прошлой ночью ушёл из жизни.	ru
La pelle degli animali è ricoperta di peli.	it
Vil det snart sne?	dk
我觉得他们不会来了。	zh
En avons-nous terminé, ici ?	fr
Vi estas mia plej kara amiko.	ep
Ein Mann kann nur tun, was ein Mann tun kann. Aber wenn er es jeden Tag tut, kann er nachts schlafen und es am nächsten Tag wieder tun.	de
Csak kezdj el beszélni.	hu
O, bizi beraber getiren şey.	tr
Tom pluvivos.	ep
You heard the news?	en
En mil kvarcent naŭdek du la judoj estis elpelitaj el Hispanujo.	ep
Lo vediamo.	it
That is how I like it.	en
Abita vicino alla diga.	it
Nancy es la chica más alta de su clase.	es
Sos bastante lista.	es
Не знаю, старше он меня или моложе.	ru
Kiom longa vi estis vivanta en Osaka?	ep
Vete de mi clase.	es
Eso no estaba planeado.	es
Tomo havis malfacilaĵojn konvinki Marion, ke ŝi rezignu sian laboron.	ep
Там внутри что-нибудь есть?	ru
Azt mondta Tomi, hogy Mária megzakkant.	hu
Они слишком поздно пришли.	ru
Ĉu vi iros al la festo hodiaŭ?	ep
Tom said he wanted to go home.	en
Kiu serĉas sendifektan ĉevalon aŭ edzinon, tiu ĉesu kaj pripensu, ke lia lito kaj stalo ĉiam restos malplenaj.	ep
Vous mangerez vos bananes.	fr
Az ókori tudás arab közvetítéssel jutott vissza Európába a sötét középkor végén.	hu
Es ist nicht alles ohne Grund, was umgeht in Volkes Mund.	de
Woher, haben Sie gesagt, ist das?	de
Io ero esterrefatto.	it
Bu teknik dergi benim üzerimdedir.	tr
Espero vê-lo novamente algum dia.	pt
Hiç kimse böyle bir kişi ile geçinemez.	tr
Deze zomer was lang en warm.	nl
Sy het droë hare.	af
Kiu ĵurnalo estas via plej ŝatata?	ep
Ты хочешь купить дом в Германии?	ru
Le marionette funzionano con i fili.	it
Ŝi prokrastis la kunvenon.	ep
Vi povus legi Kantion viaflanke, se vi volus tion; sed blagon oni kundividu kun iu alia.	ep
Том - талантливый хоккеист.	ru
Тому нужна такая помощница, как Мэри.	ru
Mondd meg Tominak, túl fáradt vagyok ahhoz, hogy segítsek neki.	hu
У тебя есть монета?	ru
Вы мои гости.	ru
Mi hanno guardata tutti con attenzione.	it
Ili ne ŝatas efektivigi tion.	ep
Tom went straight to the door.	en
We're only fishermen.	en
Es war schon Abend, als wir das Dorf erreichten.	de
Hayatımı burada harcamazdım.	tr
Can you tell me why you think that's true?	en
Mes amis disent toujours que je suis trop calme, mais ma famille dit toujours que je suis trop agaçante.	fr
The situation is growing serious.	en
You should rest after exercise.	en
I heard Tom snoring during the class.	en
Add more water to it.	en
I like the way you walk.	en
Elle a tellement envie d'y aller.	fr
Put the car into the garage.	en
The boy decided to observe and record honeybees in detail.	en
There is little, if any, hope of his recovery.	en
Nobody is cleverer than he.	en
Je ferai tout mon possible.	fr
Jen la plej bona restoracio kun marfruktoj en la tuta kvartalo.	ep
Я справлюсь с этим за пару минут.	ru
Essendo disoccupato, non posso risparmiare nulla.	it
Холмс вышел из комнаты никем не замеченный.	ru
Kan du tale fransk?	dk
Не ожидал вас увидеть.	ru
Ich werde zu spät zur Schule kommen!	de
Egalas al mi kio okazos.	ep
Люся - самая популярная девушка нашего курса.	ru
Bring einen Kannibalen mit zum Essen.	de
Ĉu vi estas novulo ĉi tie?	ep
Wyłaź spod stołu.	pl
Mi ne plu parolas kun li.	ep
Trovo le lingue straniere molto interessanti.	it
Baldaŭ ekpluvos.	ep
Kion vi opinias pri tiu filmo?	ep
Edison ha inventato molte cose utili.	it
Japán sok külföldi országgal kereskedik.	hu
Serĉu kaj vi trovos.	ep
Tom doesn't like dark colors in his home.	en
Ő egy ágrólszakadt ember.	hu
Os trens passam com mais frequência do que os ônibus.	pt
Дж.Ф. Кенеди е погребан в гробищата в Арлингтън.	bg
Ich bin alt genug, um mein eigenes Leben zu leben.	de
The heart itself is nothing more nor less than a large, tough, leather-like muscle.	en
Il se trouve que je le connais.	fr
Le piace fumare tabacco.	it
Are you on Facebook?	en
Le joueur n'a pas attrapé le ballon.	fr
Tiu historio ne malhavas spritaĵojn.	ep
Estas domaĝe, ke ni ne konis persone la majstron.	ep
Io odio gli horror.	it
Komm rein und fühl dich wie zu Hause.	de
Edukado ne plu estos privilegio de kiuj kapablas pagi ĝin, nek polico estos malbeno de kiuj ne kapablas aĉeti ĝin.	ep
Mağazanın önünde Tom'la karşılaştım.	tr
Tom went to the gym three days a week.	en
Ehdokas vastasi nopeasti kritiikkiin.	fi
O, bu hafta meşguldü.	tr
Terure pluvegis dum duonhoro.	ep
Coloque isso por escrito.	pt
Meu pai tem cinquenta anos de idade.	pt
Le bus était bondé.	fr
Il est vachement jaloux.	fr
As-tu parlé le moins du monde ?	fr
Il donnait d'ordinaire à manger à son chien, de la nourriture pour chien bon marché.	fr
Inizia la spartizione.	it
Ben karı çok severim.	tr
Я категорически отказался.	ru
Ich habe dir doch gesagt: „Lass es sein!“ Merkst du nicht, dass Keiko das hasst?	de
Li rompis la fenestron intence.	ep
Kiajn bestojn mi povos trovi ĉi tie?	ep
Lekarz dał jej pigułki przeciwbólowe.	pl
Néhány nappal ezelőtt elutazott.	hu
Bu motor en çok yakıtı tüketiyor.	tr
Mi ŝatus trovi pli da tempo ol mi povus dediĉi al malstreĉiĝo.	ep
Я ищу хороший отель.	ru
Tom non ha figli.	it
Mon sens de l'odorat est atténué.	fr
Each of us leaves life with the feeling that they were just born.	en
La Ĉarto de la Fundamentaj Rajtoj de la Eŭropa Unio sankcias eksplice la malpermeson de diskriminacio pro seksa orientiĝo.	ep
Ninguém acreditou nele.	pt
Эти ребята будут счастливы, если мы подарим им мяч.	ru
We usually went to the zoo on Wednesday.	en
Dile a donde debe ir.	es
En la horo de nia renkontiĝo brilas stelo.	ep
Şimdilik halamla birlikte kalıyorum.	tr
Mi iros vidi je Mary ĉi-posttagmeze.	ep
Quest'area continuerà ad essere piovosa.	it
I thought Tom would be valuable to you.	en
Kiel vi lernis tiel bone danci?	ep
Tom aime les poneys.	fr
Io sono qui per aiutarla.	it
Du kannst es umsonst haben.	de
Ni helpos al ni.	ep
Doch die Menschheit gedenkt auch hier nicht stehenzubleiben: der Begriff „intelligentes Haus“ ist dabei, sich einzubürgern.	de
Пожалуйста, не забудь встретиться с ним завтра.	ru
Avete controllato il nostro negozio di recente?	it
We could crash.	en
I admire your work ethic.	en
Vem ska avlösa henne när hon inte orkar längre?	se
Dir wird dieses Spiel nicht gefallen.	de
La lernantoj malobeis al siaj instruistoj.	ep
Maria verwickelte Tom in ein Wortgefecht.	de
Stockholm är Sveriges huvudstad.	se
Det är galet varmt idag.	se
Es el árbol más grande que he visto.	es
Am Ende ist es immer das Fällige, was uns zufällt.	de
A me piacerebbe un Manhattan.	it
Je m'assis.	fr
Io ero a piedi nudi.	it
Tom e Mary sono fratello e sorella.	it
Eu estou à beira de uma crise de nervos.	pt
Tom'un Mary'yi sevip sevmediğini merak ediyorum.	tr
Paghi tu?	it
Questo mi fa sentire vecchio.	it
Was ist Tom widerfahren?	de
Oh, you don't want to eat your vegetables? How about a kick in the ass? No? Then eat and stop whining.	en
Soy un granjero.	es
Maria faris unu paŝon dorsen, kaj la balono ekis altiĝi iom post iom.	ep
Mancherete.	it
Hoy no puedo concentrarme en mi trabajo.	es
Soon I will be very rich.	en
O bebê está dormindo. Não faça nenhum barulho.	pt
Vielleicht habe ich mir das nur eingebildet.	de
Tu as été adoptée.	fr
Vous vous êtes assises.	fr
Wer sich in einer Streitfrage auf die Autorität beruft, gebraucht nicht die Vernunft, sondern eher das Gedächtnis.	de
Da cristiana quale sono penso che non sia mai diritto del più forte decidere della vita del più debole.	it
Me ha tocado una bici en un sorteo.	es
Vous êtes locataire ou propriétaire ?	fr
Mi trovis mian vazon dispecigita.	ep
Ad etiketini takman gerekiyor.	tr
Non glielo hai detto?	it
Manjo frapis lin je la kapo.	ep
Um grande asteroide foi responsável pela extinção dos dinossauros.	pt
Если ты его попросишь, он тебе поможет.	ru
Ich hätte möglicherweise das Gleiche getan.	de
That must be fascinating.	en
Nutru min.	ep
Has Tom told Mary what to do?	en
What did Tom tell Mary about John?	en
У двери какой-то человек.	ru
Ha creduto e crede ancora in me?	it
La salsiccia non la trovano?	it
Вие всички сте глупаци.	bg
Io vidi qualcosa di molto brillante volare nel cielo notturno.	it
The first step is the most important step.	en
Sənin haqqında eşitmişəm.	az
Lia patro min vokis.	ep
Rimani fuori dalla vista.	it
Ma che partita hai visto stasera?	it
Doktor hasta için ilaç yazdı.	tr
Precisamos de um médico!	pt
Nunca estive na Alemanha, até agora.	pt
Tom Osteoporoz'dan muzdarip.	tr
Neden kötü şeyler oluyor?	tr
Kaj ĉu plaĉus al vi kune ludi marelon?	ep
माझी आज मान दुखते आहे.	ma
Я должен найти Тома.	ru
Том проспал весь фильм целиком.	ru
Простите, у меня нет сдачи.	ru
Qui suis-je pour le piler ?	fr
Ei ole kieltä, joka olisi yhtä kaunis kuin portugali.	fi
Tom soğuğa karşı çok hassastır.	tr
Je ne sais assez te remercier pour l'aide que tu m'as fournie.	fr
Who did you hear that rumour from?	en
Они всю ночь были со мной в той комнате.	ru
Vous êtes désolé.	fr
Tomaso ne povas helpi vin.	ep
Eu gosto muito de jogar futebol, e você?	pt
Peki kimdi bunlar?	tr
Tom is from my neck of the woods.	en
I think you've been listening to the wrong people.	en
Trovo sia magnifica.	it
Powiedziałeś, że potrzebujesz pomocy.	pl
We love each other, but we don't have sex anymore.	en
Mi ha interrotta.	it
Mijn tenen bevriezen.	nl
Skulle du kunna låna mig saxen?	se
Hier ist der Hut des Vaters.	de
No one is immortal.	en
Qui êtes-vous, exactement ?	fr
Loro pitturarono la casa.	it
Man sollte versuchen, sich mit seinem Nachbarn gut zu verstehen.	de
Çizgi romanlar eskisi kadar popüler değil.	tr
I'll tell them what I know.	en
Thanks for calling me back.	en
Neredeyse bir yıldır beraberiz.	tr
Sie wissen sicher schon, was zu tun ist.	de
Се согласуваме.	mk
Pourquoi cette lumière clignote-t-elle ?	fr
This is what you need to do first.	en
Добар морепловец сум.	mk
Os erros contribuem para melhorar a capacidade de ler e concentrar-se.	pt
Кто в лес, кто по дрова.	ru
Joku on varastanut minun tavarani.	fi
Jen la domo, kie mi naskiĝis.	ep
Noi abbiamo dimenticato tutto di loro.	it
La ville était belle avant-guerre.	fr
A che ora va a letto?	it
Devi immaginarteli così?	it
Tom biraz çay yudumladı.	tr
Onu neden söyledik?	tr
Tom tinha um cachorro.	pt
Том е дебел.	mk
Mennyire hiányzok?	hu
Не ли ви беше забавно?	mk
Ты подождёшь меня?	ru
Behöver du någonting annat?	se
Tom'un bir çocuğu vardı.	tr
Mely okból nem jöhetett velünk?	hu
Három lánya van, az egyik férjhez ment, de a másik kettő nem.	hu
Tom ona yardım edemedi.	tr
Tom, babasının portresine baktı.	tr
Он наклонился к ней и сказал: «Нет, я не вру».	ru
Kim sana yardım etti?	tr
Том и Сью знакомы с 1985 года.	ru
Kial posedi grandan fridujon en tute malgranda loĝejo?	ep
Er liebt sie und mich.	de
Je méritais ça.	fr
Você precisa trabalhar aos domingos?	pt
Tom is my youngest brother.	en
Polislerle başı hep derde giriyordu.	tr
Ez a latin nagyon rémes.	hu
Я знал об этом неделю назад.	ru
Senin yeni bir ev satın aldığını duydum.	tr
Io ero troppo impegnato per scriverle.	it
Hadi, kalkalım!	tr
Çalıştığın şeylerin hepsini riske atma.	tr
Тогда Вениамин увидел, что она - его сестра и сказал: "Я Вениамин, младший из твоих братьев". И она зарыдала от радости, и Вениамин тоже, и они целовались и обнимались с величайшей любовью.	ru
Ek wil nie.	af
Egy évtizedben tíz év van.	hu
Biz Boston'da fazladan üç gün kaldık.	tr
Всё своё свободное время она посвящала рыбалке.	ru
Non ricevetti l'invito.	it
Мне нужно помыть руки и почистить зубы.	ru
Jeg hedder Ahmad.	dk
Era interessante per me.	it
टॉमला सांग तू खोटं बोललीस.	ma
Las estadísticas están de tu lado.	es
Ebeveynlerim onun ırkından dolayı erkek arkadaşımı sevmiyor.	tr
Для них это был конец.	ru
फ्रांस्वाने भाषण दिलं.	ma
Jim szereti a doktort	hu
¿Eres feminista?	es
Tom morì in Australia.	it
Questo posto è come una gabbia di matti!	it
Notre avion est en retard de trente minutes.	fr
Ziehe deine Schuhe aus, bevor du ein Haus betrittst.	de
Vissza akarom kapni a kulcsomat.	hu
Tom ile sorunlar yaşıyorum.	tr
Bu aslında oldukça ilginç görünüyor.	tr
Elles regardaient une belle image.	fr
Van egy kérésem.	hu
Çalışması onu tüketiyor.	tr
The inscription carved into the rock is from the sixth century B.C.E.	en
Azóta sok minden változott Bostonban.	hu
La più grande nave da crociera al mondo si chiama "Harmony of the Seas". È stata inaugurata nell'anno 2015.	it
Tom está sem palavras.	pt
Ho spedito il mio curriculum a dieci imprese diverse.	it
Biraz daha çay istiyorum.	tr
Joseph ölümden bir çağrı duyduğunu söylüyor.	tr
À quelle distance c'est d'ici ?	fr
Я не такая наивная, чтобы продолжать верить в твои сказки.	ru
Tom has changed his mind again.	en
It is inefficient of you.	en
Ĉu vi estas provanta paroli kun tiu persono?	ep
Вам надо было вчера прийти.	ru
Tom ne jouera pas au tennis aujourd'hui.	fr
Мне стало обидно до слёз.	ru
Ci siamo rilassate in salotto.	it
Non avevo altra scelta che credere a Tom sulla parola.	it
Je veux dessiner un coucher de soleil.	fr
Noi siamo andate allo zoo.	it
Era frequentemente in ritardo per la scuola.	it
Попроси Тома присутствовать на собрании.	ru
Szánt szándékkal rálépett a lábamra.	hu
Mary çizmelerini bağladı.	tr
Ni baldaŭ alvenos, post dekkvin minutoj !	ep
Non ero impressionato.	it
Suis-je si mauvais ?	fr
Remettre en forme après lavage.	fr
I have a sharp pain in my chest.	en
Can you save enough money for the down payment?	en
"Do you mind my smoking here?" "No, not at all."	en
Il nous donne beaucoup de mal, mais je l'aime quand même.	fr
The best is behind.	en
In my opinion, it's quite unsuitable.	en
I'm looking for an old man.	en
I took a walk with my dog this morning.	en
He started a new life.	en
My car is broken and it's in the shop now.	en
Do you think we'll get a chance to rub shoulders with any celebrities?	en
Nie każ mi powtarzać.	pl
Je älter man wird, desto schwächer wird das Gedächtnis.	de
Chi ha scritto la lettera?	it
Je dois mon succès à mon ami.	fr
I am buying a new car.	en
La aerpoluado grave problemas en tiu lando.	ep
我抱着去美国的想法学英语。	zh
Вибачте мене, будь ласка.	ua
Le plus grand plaisir que je connaisse, c'est de faire une bonne action discrètement et qu'on la découvre par hasard.	fr
Won't you give me a little money?	en
En komparo kun lia posteulo, li estis pli laborema.	ep
Niektórzy urzędnicy mogli zostać skorumpowani.	pl
Seninle tanıştığıma memnun oldum.	tr
Frazo povas konsisti el unu propozicio.	ep
This was a translation of copyrighted material, so I deleted it since copyright owners have the right to control derivative works.	en
Onklino Thea veturis al siaj genepoj en Kalifornio.	ep
你每天来这里吗？	zh
Er kam dreißig Minuten zu spät.	de
Malgrandaj knabinoj ĝenerale ŝatas pupojn.	ep
Li fiksrigardis min de kapo al piedo.	ep
Estland heeft zijn eigen volkslied.	nl
The author is seventy but he's no less productive than he was twenty years ago.	en
Le Royaume-Uni doit perfectionner les solutions face aux problèmes posés par son réseau de chemins de fer.	fr
Dieses blöde Lied geht mir nicht aus dem Kopf.	de
Está en Babia.	es
No puedo soportar más este calor.	es
Hvernig get ég hætt í þessari vinnu?	is
Impossible.	en
Le couteau était si émoussé que je ne pus couper la viande avec et je dus recourir à mon couteau de poche.	fr
Mia kato mortigis sciuron.	ep
Cette terre donne de bonnes récoltes.	fr
A Terra gira ao redor do Sol.	pt
Cerbumu antaŭ ol agi!	ep
Tom didn't like living in the country.	en
Tom and Mary don't have much in common.	en
Ich bin ein armer Tischler.	de
Il était tout sauf robuste.	fr
Egy lakásban lakom.	hu
Lui è un nuovo arrivato.	it
Vedrai.	it
John seninle tanışmadan önce tembeldi.	tr
Nixon, 1972 yılı seçimini büyük bir halk oyuyla kazandı.	tr
You should find a more constructive way of venting your anger.	en
Dün bir arkadaşımla bir film izlemeye gittik.	tr
Ich weiß nicht, warum ich ihm nicht gefalle und das ist auch nicht wichtig.	de
Bütün gece uyumadan uzandı.	tr
É melhor você não comer aquele bolo!	pt
There's an eighty to ninety percent chance that Jane will come.	en
Ne malĝoju!	ep
O rei se virava e se revirava diante do espelho.	pt
Tom no fue y yo tampoco.	es
Я был удивлен его внезапным появлением.	ru
Tek başıma gece geç saatlerde eve yürümemeliydim.	tr
I'd love to learn how to fly a helicopter.	en
J'ai tout de suite deviné leur complot.	fr
Les implications en sont effrayantes.	fr
Bay White onlara yardım etmek istedi.	tr
Для меня честь работать с Томом.	ru
I don't know how he can live in this mess.	en
Estas nia devo helpi unuj la aliajn.	ep
Me gustaría presentarte al caballero del que te hablé el otro día.	es
Mi preskaŭ finlegis la romanon.	ep
La lingua comune di molti anime è rappresentata dai sottotitoli.	it
Nenhum dos tiros atingiu o coração, mas causaram vários estragos a outros órgãos vitais.	pt
Debió usted discutir ese problema previamente conmigo.	es
İş daha da kötüye gitmeye devam ediyor.	tr
La hija estaba afligida por la enfermedad de su madre.	es
Ist deinen Eltern bekannt, dass du dir einen Irokesenschnitt machen lässt?	de
Celui qui veut être heureux pour un jour doit se soûler. Celui qui veut être heureux pour un mois doit tuer un cochon. Celui qui veut être heureux pour un an doit se marier. Celui qui veut être heureux pour une vie doit aimer sa profession.	fr
Tom dejó su trabajo la semana pasada.	es
Había trabajado todo el día, así que estaba muy cansado.	es
Inizialmente quel suono mi infastidiva, però ora mi ci sono abituata.	it
Tom ist ein großartiger Künstler.	de
Che fa per Halloween?	it
Sie und ich sind Brasilianerinnen.	de
If you want to stay, you can stay.	en
Şimdi bir hemşireye ihtiyacım var.	tr
El señor Wilson está encolerizado con Dennis.	es
Non posso comprarti quel vestito.	it
Kimse onu desteklemedi.	tr
या गोंधळासाठी तु जबाबदार आहेस का?	ma
Я сказал ему прийти завтра.	ru
Er ist kein Apotheker.	de
Tu as pleuré et tu as cru.	fr
Porto dei dolci per i bambini.	it
Einen schönen Valentinstag!	de
No he tenido noticias suyas durante mucho tiempo.	es
They look sad.	en
That's really odd.	en
Ma jól néz ki.	hu
That's a distinct possibility.	en
I can never tell when you're kidding.	en
Hvert kongresmedlem kunne stemme.	dk
Lin trafis apopleksio.	ep
मी दर सकाळी साउअरक्राउट खातो.	ma
Он забыл часть своего выступления и был вынужден какое-то время импровизировать.	ru
I saw what was left.	en
Die Menschen haben sich lange gegen die Existenz der Zahl Null gewehrt und diese als teuflisch abgetan.	de
Tous les racistes sont des hypocrites.	fr
Je veux te voir en premier.	fr
Sınavlar bile bir test miydi yoksa?	tr
Открывайте коробку.	ru
Sie will noch eine Weile im Bett liegen.	de
I'm in the middle of something here.	en
Sebebini sordum.	tr
Sie müssen sich von solchen Leuten fernhalten.	de
Eu sou rico.	pt
Bu akşam final sınavları için hazırlanacağım.	tr
Моля те, говори ми на френски.	bg
Я очень устала от тяжёлого труда.	ru
Sie ist solch eine Heuchlerin!	de
Tio ŝajnas esti kerna gravaĵo.	ep
Io non capisco dove ho sbagliato.	it
Parece ótimo.	pt
O tempo faz esquecer muitas lembranças.	pt
Ta chaise est si confortable que je pourrais y rester des heures.	fr
Das Zungenbein ist ein kleiner, hufeisenförmiger Knochen, der bisweilen zu den Schädelknochen gezählt wird.	de
Если бы я об этом знал, я бы никогда ей такого не сказал.	ru
Tiu kuko bone aspektas.	ep
Стена белая снаружи и зелёная внутри.	ru
Elle ne salue pas ses voisins.	fr
Трябва да се преоблека за работа.	bg
Quanto mais velho vou ficando, mais nitidamente me recordo de coisas que nunca aconteceram.	pt
Wenn alles Private von Geheimdiensten ausgeforscht wird, ist das Demokratie?	de
È molto intelligente, come suo fratello.	it
Il a amélioré ses résultats.	fr
Há muita coisa ruim neste mundo, mas nada é pior que uma cabeça fraca.	pt
Tom a torturé un prisonnier.	fr
Tomo konfesis, ke li mortigis Manjon.	ep
Tom is driving a rental car.	en
Ненавижу, когда меня фотографируют.	ru
Il commence à m'énerver celui-là.	fr
Tom yemek odasında.	tr
In het Esperanto is er geen onbepaald lidwoord, en slechts één bepaald.	nl
Что делает Том?	ru
Tomin piti olla täällä kolme tuntia sitten.	fi
Betrachten Sie sich gern im Spiegel?	de
La giornata non poteva andare meglio, peccato solo per il tempo.	it
Hij vertelde me: „Ik heb gisteren dat boek gelezen”.	nl
Sinun olisi pitänyt suudella Tomia.	fi
Elprovu, pripensu kaj komprenu tion!	ep
Nadie ve mis lágrimas.	es
Eu não estava com pressa.	pt
Я знал старика, который говорил, что за всю свою жизнь он ни разу не ел в ресторане.	ru
Alle bisherigen Bewegungen waren Bewegungen von Minoritäten oder im Interesse von Minoritäten. Die proletarische Bewegung ist die selbständige Bewegung der ungeheuren Mehrzahl im Interesse der ungeheuren Mehrzahl.	de
Il problema non era la pista bagnata?	it
Bu iyi bir sistem.	tr
Не говори глупости!	ru
Теперь Марк не смеётся.	ru
Tom güvenilirdi.	tr
Ni scias kial vi faris tion.	ep
Tudnál még valamit enni?	hu
Пожалуйста, не трогайте товары.	ru
Tom, sag, was ist nicht in Ordnung?	de
Mi puoi mostrare dove mi trovo su questa mappa?	it
Belki bir ara tekrar konuşmak istersin benimle.	tr
Je handen beven.	nl
Есть возражения?	ru
Elolvadt a hó.	hu
Tom sırasının arkasına oturdu.	tr
Wenn das aus irgendeinem Grund passieren sollte, was würdest du tun?	de
Ele não queria admitir que não conseguia ver nada.	pt
टॉम बेशुद्ध नव्हता.	ma
La biología le interesa mucho.	es
Настало время прогноза погоды.	ru
Eu ouvi falar disso.	pt
Lei aveva un gatto.	it
Is the post office near here?	en
Io ho già bevuto tre caffè.	it
The use of deadly force has been authorized.	en
Non sono più il vostro angelo.	it
This was too much for him.	en
Qu'est-ce qui a déclanché l'alarme ?	fr
Том написал что-то на обороте конверта.	ru
Tom spielt oft mit Mary Gitarre.	de
Wake me up when you get home.	en
Kendini hâlâ deniz kuvvetlerinden mi sanıyorsun?	tr
Tom'un sorunlarını seninle tartışmak istemiyorum.	tr
El la gudro oni ricevas per distilado multajn derivaĵojn.	ep
To jezioro jest najgłębsze w tym kraju.	pl
Bunun bir intihar olduğunu düşünmüyorsunuz, değil mi?	tr
Он пишет письмо своему брату.	ru
Не ждите, что все будут думать так же, как вы.	ru
Ĉu mi sonĝas?	ep
Куда я положил своё пальто?	ru
Мередит ѝ е пријателка на Мери.	mk
Тоа е за нив.	mk
Tom a volte è troppo emotivo.	it
Ezt a szót javaslom idézőjelek közé rakni.	hu
Морав да си ја вршам должноста.	mk
Morgaŭ venos malproksima kuzino.	ep
Летото и есента се пријатели.	mk
Spojrzał na mnie i zaśmiał się.	pl
पोस्टाने पाठवली.	ma
Diventa davvero più facile.	it
Bunu nasıl yapacağımı bana öğreten Tom'du.	tr
Tu sam jer mi je rečeno da dođem.	hr
A herceg fölemelte a puskát és célzott.	hu
Не надо было мне столько есть.	ru
I watched the sun rise over the city.	en
Она с легкостью забралась на коня.	ru
Gerçekten onu yaptın mı?	tr
I will open the door.	en
Je suis bourrée.	fr
Не похоже, чтобы Том был очень занят.	ru
Ella no quiere estar con nadie.	es
Zo iets gebeurde hier nog nooit.	nl
Tom Mary'yi telafi ettiğini söylüyor.	tr
Das Baby schläft. Macht keinen Lärm.	de
C'è anche il ristorante?	it
Я сказал ей, что я ей помогу.	ru
Chciała im pomóc.	pl
Noi sprechiamo molto tempo.	it
A társam nem néz szappanoperákat.	hu
En la restoracio oni ofertas kradrostitan salmon.	ep
Vi adiciis ĉiujn ciferojn.	ep
Queste pagine, dalla prima all'ultima, sono state scritte con il più profondo senso di gratitudine.	it
Tatlı için pasta yiyecektim ama fikrimi değiştirdim.	tr
Вам нужно выбрать собственный путь.	ru
La virino, kun kiu Tomo eliras, kvar fojojn edziniĝis.	ep
Eso no es una isla.	es
Was denkst du eigentlich über Tom?	de
Что ты подарил Тому на день рождения?	ru
Eu não sei o que há no topo da montanha.	pt
Они любят дождь и снег.	ru
Tom disse que está se sentindo bem.	pt
Все её слова - клевета.	ru
Három macskája van.	hu
Tom yardım için seslenen birini duydu.	tr
Krom la angla li instruas ankaŭ matematikon.	ep
Tom fell desperately in love with Mary.	en
Lei sta perseverando.	it
Ich stehe gewöhnlich früh auf.	de
Hé, ne touchez à rien !	fr
Non l'ho mai chiesto a Tom.	it
Gerçeği Tom'a asla söylemedim.	tr
You have to do what you were told to do.	en
Szerintem a francia egy nagyon nehezen elsajátítható nyelv.	hu
Для завершения этого проекта нам нужно около трёхсот тысяч долларов.	ru
Acımasız rekabet karşısında, bizim iş hayatta kalmakta başarısız oldu.	tr
Я не выношу этой боли.	ru
Мальчики громко спорят.	ru
Tom bir kamyon tarafından çarpılmaya oldukça yaklaştı.	tr
Nós obedeceremos.	pt
Che altro posso darvi?	it
Ты ведёшь себя как дура.	ru
Том любит эту игру.	ru
Necesas al mi via amo.	ep
Прошу прощения. На чём я остановился?	ru
Tom had to know about it.	en
Если я возьму три пары, будет скидка?	ru
Bana bir suçlu gibi davranmaya nasıl cüret edersin!	tr
The stars shone all the time.	en
When did you finish writing the report?	en
We made brochures at small cost.	en
My uncle comes back from America next Monday.	en
Years of heavy drinking has left John with a beer gut.	en
Don't move, or I'll shoot you.	en
He had the kindness to help me.	en
They are sufficiently well off to be able to spend each winter in Florida.	en
I'm fed up with her.	en
Appelle-moi dès que tu l'auras rencontré !	fr
我现在好多了。	zh
Nauczyciel upomniał go, by już się nie spóźniał.	pl
Skolan ser ut som ett fängelse.	se
Её отец стал инвалидом в результате сердечного приступа.	ru
Nous lisons la lettre encore et encore.	fr
Ne te fais pas autant de soucis, ou tu deviendras chauve.	fr
Le roi fut amputé de son pouvoir.	fr
Li rampis kvarpiede kiel kato.	ep
De directeur van de school wil de kantine sluiten en een nieuwe recreatieruimte creëren voor de studenten.	nl
Mi planas elmeti miajn rozojn en florekspozicio.	ep
Ĉu vi iam vizitis Usonon?	ep
Ŝi havis tristan vizaĝesprimon.	ep
Ĉu estas iuj libroj sub la skribotablo?	ep
Est-ce que tu es libre mardi ?	fr
Mi tute forgesis lian nomon.	ep
Tom noted in his report that the stock market was a factor in the company's failure.	en
Ni respektu la regulojn.	ep
Sógorom valódi egoista.	hu
Możesz ozdobić koktail wisienką lub ananasem.	pl
Ależ było ciężko...!	pl
Mi estas lernanta du fremdajn lingvojn.	ep
We have two cats in the house: one white, and one black.	en
Eĉ se li estas tre okupata, li tamen venos.	ep
Dün hava soğuktu.	tr
Она не доверила мне свой секрет.	ru
Nie siedź za długo.	pl
Les prévisions météorologiques se basent sur les données du passé.	fr
Hversu margir vagnar eru í Tsúbasa lestinni?	is
Trots att det regnade ställdes matchen inte in.	se
Je suis vraiment content d'être tombé sur toi.	fr
La tria potenco de tri estas dudek sep.	ep
Bu sözcük Latince kökenli.	tr
You need a lot of water.	en
Ahí se va mi última oportunidad.	es
Et pour tous ces Américains dont j'ai encore à gagner l'appui, je peux ne pas avoir gagné votre suffrage ce soir, mais j'entends vos voix.	fr
Una volta ho conosciuto un carcerato	it
La libro ruĝas.	ep
Faisons une pause.	fr
Você acha o croata uma língua interessante?	pt
Tom di solito va a letto alle dieci e quaranta.	it
Bay Johnson kazandığı paradan dolayı, emekli olduğunda etrafa para saçabilecekti.	tr
Tom ve Mary üç çocuğu evlat edindiler.	tr
Kissanpentu halusi sisään.	fi
Zeg hen mij te bellen voordat ze vertrekken.	nl
Os portenhos são pessoas muito simpáticas e alegres.	pt
Matena ruĝo, ter' endanĝeras. Vespera ruĝo, reaktor' ekbrulas.	ep
Ĉu vi volas ĝin kunporti aŭ manĝi ĉi tie?	ep
Il aime lire des livres.	fr
Un bébé ne distingue pas le bien du mal.	fr
Homo, kiu estas dirinta la veron, ne estas riproĉinda.	ep
Io lavoro come insegnante.	it
Балапан ұяда не көрсе, ұшқанда соны алады.	kz
Königinnen beflecken ihre Tugend nicht. Ihr seid des Todes, wenn Ihr zweifelt.	de
Scusatemi. Mi potreste indicare la stazione della metropolitana più vicina?	it
Плов с мясом — восемь юаней; вегетарианский — всего четыре юаня.	ru
Mi deziras havi ĉefserviston kiel Tom-on.	ep
Höre auf, mir vorzuschreiben, was ich zu tun habe, und kümmere dich um deine eigenen Angelegenheiten!	de
Времена изменились.	ru
Die Kinder putzen sich die Zähne.	de
Okumak kelime dağarcığınızı geliştirmenize yardım eder.	tr
Ni kredas, ke li honestas.	ep
En nia vendejo vi povas elekti el larĝa sortimento da erotikaj ludiloj.	ep
Was Tom alone?	en
İşimi bitirdiğimde sana yardım edeceğim.	tr
La verdad finalmente salió a la luz durante su juicio.	es
Du akzeptierst Toms Scheck, warum willst du nicht meinen Scheck akzeptieren?	de
¿Por qué la gente te tiene miedo?	es
Je sais que tu caches quelque chose.	fr
Why would you want it?	en
Ich wollte hinausgehen, um frische Luft zu schnappen.	de
Found anything interesting?	en
Me gustaría hablar con Tom sobre su hermano John.	es
Mi ŝatus ne devi labori.	ep
Como elas estavam com pressa, pegaram um táxi.	pt
Je suis reconnaissante pour tout ce que vous avez fait.	fr
Van egy rottweilerem.	hu
Soy menos activo que mi hermano.	es
Bröd bakas i ugn.	se
I should've called.	en
It seemed appropriate.	en
Tom doesn't look too sure.	en
Die Freiheit des Menschen liegt nicht darin, dass er tun kann, was er will, sondern dass er nicht tun muss, was er nicht will.	de
汤姆救了玛丽的命。	zh
Lei morirà.	it
Als ich klein war, in Brooklyn, hat keiner Selbstmord begangen — dafür waren alle viel zu unglücklich.	de
I taught Tom everything he knows.	en
Je ne dispose pas de la réponse.	fr
Ela conheceu um novo amigo na escola hoje.	pt
A me serve una risposta.	it
La festo estis tute teda.	ep
I wonder if I should warn Tom.	en
Обвиняемый должен предстать перед судом в пятницу.	ru
Hast du schon einmal versucht, einen Witz auf Französisch zu erzählen?	de
Я ожидаю от тебя пунктуальности.	ru
Вчерашняя ночь была очень жаркой и душной, поэтому я не спал достаточно хорошо.	ru
Lui ha una bella auto.	it
С трудом верится в то, что ты говоришь.	ru
Oni ege bezonas flegistojn en tiu malsanulejo.	ep
Aspetti che inizi la partita.	it
Io sono sempre stato onesto con te.	it
En tiedä oikeaa vastausta.	fi
Noi stavamo andando a vela.	it
Здесь часто идёт снег.	ru
Джиро Акагава написал более 480 романов.	ru
In the end, Tom had to bite the bullet and take responsibility for his actions.	en
Li faligis malamikan aviadilon.	ep
Posso condividere.	it
Tom beklediğinden daha fazlasını aldı.	tr
Вы не планируете присоединиться к нашей компании, чтобы выпить что-нибудь попозже?	ru
Boule de Suif est la seule qui a choses à manger.	fr
Are you prepared to just let that happen?	en
Un sacco di fotografie sono appese nella sala riunioni.	it
Tom entschuldigte sich und sagte, es tue ihm leid, er habe sich im Ton vergriffen.	de
Voisin tehdä tätä päiviä.	fi
Behatóbban akarjuk vizsgálni, hogy ez, hogy működik a gyakorlatban.	hu
Sorunlar olduğunu mu söylüyorsun?	tr
En ole pelännyt ikinä niin paljon aikaisemmin.	fi
We should be getting back to work.	en
Я думал, Том будет знать, как это сделать.	ru
Mi assento per un attimo.	it
Ты всего лишь ребёнок.	ru
Hangi bacak acıyor?	tr
Mary ile aramı bozdun.	tr
Annettuaan Tomille litsarin Mari juoksi ulos huoneesta.	fi
Há mais uma coisa que quero discutir com você.	pt
Niemand gaan omgee nie.	af
Köpek zeki bir hayvandır.	tr
Ya hemos visto esta película.	es
«Видел странный сон». — «Какой сон?»	ru
I want to finish the text here.	en
Мне нужно поговорить с вами об этом.	ru
Sanırım onun iki oğlu var.	tr
Ja forgesu Tom.	ep
Gillar du verkligen inte de där killarna?	se
Беше доста близко.	bg
Torna nel recinto!	it
Tom kuuli koputuksen ja käveli ovelle avaamaan sen.	fi
Voi avete fatto colazione alle otto.	it
Osaatko hoitaa kirjanpitoa?	fi
Он действительно любит научную фантастику.	ru
Bugün ne içmek istersin?	tr
I had nothing to say to them.	en
Do you see him anywhere?	en
Произведения Булгакова по праву вошли в сокровищницу русской литературы.	ru
My favourite colour is blue.	en
Bu aralar, bulunmak için buradan daha güvenli bir yer yok.	tr
Credo che voi abbiate incontrato Tom.	it
Луѓето не можат да творат чуда.	mk
Wie viele Fenster gibt es in dieser Klasse?	de
Dan shouted out a racist insult.	en
Давайте я пойду поговорю с ними.	ru
यादी कुठेय?	ma
Hol van a pénztár?	hu
Renversiĝis do la mondo! almozuloj estas reĝoj, kaj reĝoj estas almozuloj.	ep
Es ist gut gegen die Krankheit.	de
Biz uyanık kalmak zorundayız.	tr
Non diverto i bambini.	it
Gerçekten Tom'a yardımcı olmak istiyorum.	tr
Тебе придётся поверить мне на слово.	ru
2.30'da buluşmamız gerekiyor.	tr
He explains the literal meaning of the sentence.	en
People often feel ten feet tall and bulletproof after taking ice.	en
टॉम आपला मित्र आहे.	ma
Tom è consapevole di quello che ha fatto Mary?	it
Paĉjo aĉetis por mi aviadilan maketon je Kristnasko.	ep
Том бара причина.	mk
Es bueno hacer lo mejor que se pueda.	es
Её напугал его кровожадный взгляд.	ru
Не ме терај да бирам.	mk
Io tamen puŝis lin. Kvankam nekutima je publika uzo, lia voĉo kreskis kaj fariĝis laŭta.	ep
Мы мёрзли.	ru
Chiunque abbia da dire qualcosa su questo matrimonio, parli adesso oppure taccia per sempre.	it
Peu importe ce que tu dis, les anglicismes japonais restent du japonais.	fr
Давно вы там работаете?	ru
Я тебе всё верну с процентами.	ru
Не зная, что делать, я вызвал полицию.	ru
Çabalarınız bir gün meyve verecek.	tr
Tom estaba como un pulpo en un garaje.	es
Rossz viselkedése meglepett engem.	hu
Не помогай мне! Я сама.	ru
O uygun olabilir.	tr
Ik denk dat Tom te veel van ons verwacht.	nl
Traspase juntas las tres hojas de papel.	es
Ich repariere sie nicht.	de
Behatolt a magán szférájába.	hu
Tomo volis, ke Manjo sciu tion.	ep
Quais são as cinco cidades mais famosas do mundo?	pt
Der König und seine gesamte Familie wurde in einem fürchterlichen Gemetzel getötet.	de
Времени осталось немного.	ru
Felkapcsolta a villanyt.	hu
Ne tür bir solunum aleti kullanıyorsunuz?	tr
Как ты научился это делать?	ru
Biz stüdyoya gidemeyiz.	tr
Le chantier est à l'arrêt depuis plus d'une semaine en raison des intempéries.	fr
Eliru el mia hejmo!	ep
Tom'un hâlâ işe ihtiyacı var.	tr
В Испании ужинают очень поздно.	ru
Io vorrei annullare la mia prenotazione.	it
As crianças já estão aqui.	pt
Tom não trouxe o que eu pedi.	pt
Everyone says that the food at this restaurant is very good.	en
Então eu era feliz.	pt
Penso che siano pronti.	it
Tom ne yapılması gerektiği konusunda hiç bir fikri olmadığını söylüyor.	tr
Я сказал им, что вы голодные.	ru
Tom sangat suka berada di luar.	in
Tom hat das Haus kurz nach Marias Auszug verlassen.	de
Bana bir taksi çağırır mısınız, lütfen?	tr
Tom setzte sich an die Theke und aß ein Thunfischbrot.	de
Itt akarok házat építeni.	hu
Ich halte Tom für unzuverlässig.	de
Nous aurons amplement le temps.	fr
Bu hayvanat bahçesinde bir akvaryum var mı?	tr
O "Ben çok mutluyum."dedi.	tr
Bu salon maksimum 1000 kişi alır.	tr
Bu sorun, karşılıklı yanlış anlamadan ortaya çıktı.	tr
O, hayatını riske atmayı umursamaz.	tr
O bir aşk iksiri yaptı.	tr
Ho bisogno di voi in questo momento.	it
Я надеялся застать вас врасплох.	ru
Ez tök jó! Biztosan nevetni fogsz.	hu
У тебя есть час.	ru
Onun hakkında daha fazla şey bilmek istemediğim için o bana kızdı.	tr
Он одолжил мне тридцать песо.	ru
Przyjaźń jest bezcenna.	pl
Sapevo che Tom non l'avrebbe fatto correttamente.	it
Ĉi-semajnfine mi veturos al Bostono.	ep
Tom ha bevuto il suo succo d'arancia.	it
Разве это не странно?	ru
Поверни дверную ручку против часовой стрелки.	ru
Mindenki ellened játszik, és te mindenki ellen játszol.	hu
Tomo invitis Manjon por iri tagmanĝi eksteren, sed ŝi malakceptis.	ep
İki büyük viski lütfen.	tr
Non so cosa stesse succedendo.	it
Non so cosa farete.	it
Trajik haberleri duyduktan sonra, o yalnız kalmak için dışarı çıktı.	tr
Did you talk to your classmates yesterday?	en
Ne estas certe, ke li volas fari tion.	ep
Non lo interrompa.	it
Том отказался дать Мэри, что она попросила.	ru
Kolayca kazandım.	tr
Sto studiando la lingua danese.	it
I don't want to sing.	en
Tom creció con Mary y John.	es
Debemos sembrar las semillas del mutuo entendimiento.	es
Bu işi yaptırmak en az üç saat sürerdi.	tr
Faisons une pause thé.	fr
"Who is that girl?" "That's Keiko."	en
Elle a dit qu'elle se brosse les dents tous les matins.	fr
The judge concluded that the prisoner was guilty.	en
We lived close by the sea.	en
She stopped crying altogether.	en
Camino junto a ella.	es
Um wie viel Uhr sollen wir essen?	de
He said that he wanted some money.	en
Mi ne ŝatas matematikon, eĉ malpli fizikon.	ep
Tanulsz angolul?	hu
He took a book off the shelf.	en
Il est Italien.	fr
Mi klarigas al ŝi.	ep
La teatraĵistino mem estis en la teatro kaj ŝin impresis la longa aplaŭdado de la spektantoj.	ep
Ni jam estas geedzoj dum kvin jaroj.	ep
Le sue mani erano fredde come il ghiaccio.	it
Ĝis nun mi ne estis vidinta tian pluvegon.	ep
She wouldn't let up until I agreed to go to the movies with her.	en
Vi ne povas aprezi tiun poemon, ĝis vi plurfoje legis ĝin.	ep
Co robiła twoja matka kiedy wróciłeś do domu?	pl
Milduloj estas subigataj.	ep
Ŝi purigis la ĉambron por mi.	ep
Él recibió una buena educación en Inglaterra.	es
Ne marchez pas si vite. Je ne peux pas suivre.	fr
Guardavo delle vecchie foto.	it
Roy ŝajnas esti feliĉa kiam lia amatino lin telefonas.	ep
Er vergaß, ihr ein Geschenk zu kaufen.	de
Нет. Я не боюсь привидений.	ru
Ik zal hem vanavond bellen.	nl
Наоко быстро бегает.	ru
Os relâmpagos normalmente acompanham trovões.	pt
這本小說很無聊。	zh
Robin wygląda uroczo gdy śpi.	pl
Ta książka powinna ci się przydać.	pl
Heute Nacht wird es regnen.	de
La nouvelle la rendit heureuse.	fr
Você tocou justamente no assunto que eu queria discutir.	pt
Él era completamente negro y por lo tanto, lo llamaban Tango el Gato Negro.	es
Mi hermano pequeño fue herido en un accidente.	es
Tom decided to learn to live with the problem.	en
Is this your opinion?	en
Başardığına çok memnun oldum.	tr
Jane'in tek başına okula gitmesi çok zordu.	tr
Non mi sono mai sentito tanto stupido.	it
Bu kapı kapanmaz.	tr
Un poète peut survivre à tout sauf à une erreur d'impression.	fr
Je suis cosméticienne, tous les jours je transforme des filles en jolies femmes.	fr
Ŝi atendis dum horoj.	ep
Ĉu mi povas veturigi vin?	ep
Noi siamo arrivate in tempo in ufficio.	it
Ik zal de schulden van mijn zoon niet betalen.	nl
Desde janeiro eu trabalho na biblioteca.	pt
I've got to help Mary.	en
O, habere şaşırmış gibi görünüyordu.	tr
O, yüksek bir maaş alır.	tr
Ĉu vi vundiĝis?	ep
O, zor işittiğinden dolayı, o onunla her zaman yüksek sesle konuşur.	tr
Хоть я больше и не ношу эти ботинки, я не могу заставить себя выбросить их.	ru
Li ĝuas bonan socialan vivon.	ep
Tom heeft zijn belofte niet gehouden.	nl
Изобретательская смекалка Лу Баня погубила его собственную мать.	ru
Eu gosto da sua gata, mas ela não gosta de mim.	pt
Incominciamo la festa.	it
Ich habe die Absicht, hier eine Woche zu bleiben.	de
Bir öğretmen olmaya karar verdi.	tr
Elle m'a collé un coup de pied dans les couilles.	fr
Mes yeux ne voient que ce qu'ils veulent bien voir.	fr
Karpuz sıcak bir günde lezzetlidir.	tr
Sie ist gleichsam ein wandelnder Lautsprecher.	de
Babam akşam yemeği sırasında tek kelime söylemedi.	tr
Tom möchte dich gerne so bald wie möglich sehen.	de
Zuerst waren wir überhaupt nicht vertraut miteinander. Mit der Zeit lernten wir einander kennen.	de
Ho portato una giacca perché c'era abbastanza fresco stamattina.	it
I think that jacket would fit me.	en
I was born here.	en
Tom ne fait pas la différence entre le lin et la laine.	fr
Tom ist verheiratet.	de
What you want doesn't really matter.	en
Diese Frage ist zu schwierig für mich.	de
Mi son fatto controllare gli occhi.	it
Either Tom doesn't want to do it or he can't.	en
Kontraŭ la mono li povis aĉeti novan aŭton.	ep
No vayas a reuniones ilegales.	es
Estas pli simple ol ŝajnas.	ep
Frag ihn, wann der nächste Flug geht!	de
Gute Bäume tragen zeitig.	de
Die europäische Zivilisation ist geprägt durch eine Überbewertung des Gedankens, der Deduktion, des Wissens und durch eine Unterschätzung von Gefühl, Intuition und Vertrauen.	de
Era visibilmente imbarazzato.	it
It's all going to be okay.	en
I should've known.	en
Jen mia filo.	ep
Versuchen Sie in Zukunft, rechtzeitig im Büro zu sein!	de
YouTube er ikke en god website.	dk
Tout le monde le croit.	fr
Estas indikite laŭetikede, ke oni prenu du tablojdojn.	ep
Tom es diabético.	es
Mi scias, ke tio ne estas vera.	ep
Ŝi donacas multe da mono por la projekto.	ep
Elle écarquilla les yeux lorsque des mains aux gros doigts boudinés se refermèrent sur son cou.	fr
Tom przeżył wspaniały czas gdy pojechał do Bostonu.	pl
J'ai organisé un dîner, le week-end dernier.	fr
Was ist zwischen dir und Tom denn vorgefallen?	de
Je pense que Tom s'est vraiment amusé.	fr
Ещё столько всего надо сделать!	ru
Tom isn't used to city life.	en
Я состою в яхт-клубе.	ru
Boston'da kalma.	tr
Der Schreibtisch macht einen aufgeräumten Eindruck.	de
Metti un po' di sale nell'acqua che bolle.	it
I'll take anything I can get.	en
Gravas, ke ŝi aŭdas tion.	ep
Tom non beve vino.	it
Kiel en orienta Eŭropo la poluado ne ĉesas pliiĝi en Ĉinujo.	ep
”Minua ei tarvitse odottaa.” ”En minä niin aikonutkaan tehdä.”	fi
O bir arkadaş mı?	tr
Non era gelosa.	it
Ich bin ohne eigenes Verschulden in Schwierigkeiten geraten.	de
Man hatte mir jede Menge falscher Vorstellungen eingetrichtert.	de
Ho sentito tutto quello che ha detto Tom.	it
She let a room.	en
Christmas Day falls on December 25th every year.	en
Holnap délután eltávozik.	hu
Mi sono emozionato.	it
You're a swell guy, Tom.	en
Hij ziet er uit als een muggenzifter.	nl
У неё две кошки. Одна белая, а одна чёрная.	ru
Noi non vogliamo andare laggiù su quella strada, vero?	it
Gitmeliyiz ve Tom'u görmeliyiz.	tr
This partition separates the two rooms.	en
Мне тебя здесь ждать?	ru
Bonvolu doni al mi medikamenton por mildigi la doloron.	ep
Sono contento ti sia piaciuto.	it
Falando do Professor Smith, o assistente dele está um pouco surdo.	pt
Ақпараттық әріптестіктің маңыздылығы айтпаса да түсінікті.	kz
These plants are all poisonous.	en
Il Papa pesa il pepe a Pisa, Pisa pesa il pepe al Papa.	it
Ze heeft geweldige borsten.	nl
Tom is helping Mary get ready for the party.	en
Do you remember the first time you saw one of those?	en
Ze is zich van haar zonde niet bewust.	nl
Mi amiga no pudo venir.	es
Admito que essa é uma resposta ambígua.	pt
लघुग्रह पट्टी मंगळ व गुरूच्या कक्षांच्या मधोमध असलेल्या क्षेत्रात स्थित आहे.	ma
A szerződés érvénytelen, ha kényszerítették, hogy aláírja.	hu
Вы можете сказать мне, о чём речь?	ru
Non mi piace nulla qua.	it
Tu bevi del tè?	it
Der Vortrag hatte ein interessantes Thema, aber die Art und Weise der Präsentation war langweilig.	de
Non è un giovane studente americano?	it
Lei si innamorò di un vampiro.	it
Il sut enrôler dans son entreprise des dizaines et des dizaines de collaborateurs et de volontaires.	fr
Tom beni asla affetmeyecek.	tr
Eve gitmekten korkuyor musun?	tr
Tom unpacked his suitcase.	en
Tom was incredibly bored.	en
Mi diris, ke mi helpos lin.	ep
Dafür bin ich sehr dankbar.	de
Túl elfoglalt vagyok - nincs időm szórakozni.	hu
Очень опасно запрыгивать на поезд, когда он на ходу.	ru
Most is nagyon csinos vagy, mint mindig.	hu
Cos'hai detto? Non riesco a sentirti.	it
Tu pèses combien ?	fr
Vi siete messi subito in linea.	it
En tiaj cirkonstancoj estas preferinde silenti.	ep
Cumartesi, pazar gününden önce gelir.	tr
Ze werd op een jongere man verliefd.	nl
C'è una foto di Tom sulla scrivania di Mary.	it
One milliard adults are illiterate.	en
Ella se encuentra en grave peligro.	es
Настоящая любовь — как привидение: все говорят о ней, но мало кто её видел.	ru
Ma cosa abbiamo qui?	it
Tom owns a restaurant on Park Street.	en
Io voglio comprare dei libri.	it
Majoituimme siellä häämatkallamme.	fi
Погода меняется день ото дня.	ru
Pada akhirnya, kami mencapai kata sepakat.	in
Tom ha scritto questo tre settimane fa.	it
Etkö todellakaan halua mitään?	fi
Том умер от рака легких.	ru
Giotto 10 Temmuz, 1992'de Kuyruklu yıldız Grigg-Skjellerup'la yakın bir karşılaşma yaptı.	tr
Quella è una nuova lampada?	it
Bu televizyonu istiyorum.	tr
Bugünkü gazeteye göre dün Şili'de büyük bir deprem vardı.	tr
La fenêtre se trouve être fermée.	fr
Hast du Tom schon einmal Klarinette spielen hören?	de
Вместе они преодолевали жизненные трудности.	ru
Почему Том нам не помогает?	ru
Nézd meg magad felülről.	hu
Ĉu vi scipovas ĵongli?	ep
Ŝi petis lin ne forlasi sian laboron.	ep
I have heard that freemasons have a secret handshake.	en
Нека ти помогне таа.	mk
Го знаеме Павле веќе долго време.	mk
Volte.	pt
Нешто зеле.	mk
Тоа е добар почеток.	mk
Том поплавува.	mk
Végre lefeküdhetek.	hu
Emotions are contagious.	en
Некому му падна ова.	mk
They interpret ambient electronic music.	en
Den här är speciell.	se
Tom mi ha detto che non aveva molto tempo.	it
¿Cómo se pronuncia su primer nombre?	es
Что-нибудь сломано?	ru
Ik voel me gelukkig.	nl
Már lehet kapni előregyártott házat.	hu
Onların benden bir şey sakladığını biliyorum.	tr
The police believe Tom was murdered.	en
İnanılmaz şekilde şanssızdım.	tr
Tom eski bir hükümlü.	tr
Bu korkunç bir fikir.	tr
Tom przeczytał w zeszłym roku 30 książek.	pl
Вы ей позвонили?	ru
Sei dislessica?	it
Mi volt a fedőneved?	hu
Вы говорите на каком-нибудь ещё языке, кроме английского?	ru
Ezer forint darabja az aranyhalnak.	hu
Ты умеешь читать и писать?	ru
My hands are full.	en
Tom'un onun ne anlama geldiği konusunda fikri yok.	tr
İrlandalı göz kırptı.	tr
Nós não estamos zangados.	pt
Les populations palestiniennes se font massacrer dans leur propre pays.	fr
La landa asocio organizas la universalan kongreson.	ep
Ŝi ricevis permeson uzi la veturilon.	ep
We've had success doing that.	en
Das altmodische Wort Zufriedenheit mit sich und der Welt ist, trotz allen Fortschrittsglaubens, ob wir es wahrhaben wollen oder nicht, der Schlüssel zum Geheimnis des Glücks.	de
Paul is smarter than Otto.	en
A lei pune os que a infringem, obrigando-os a dar algo à sociedade.	pt
Собака бывает кусачей только от жизни собачей.	ru
Ĉu estas tro pridemandi vin?	ep
Io non ce la posso fare questa volta.	it
La viro parolis mallaŭte.	ep
It was a great day.	en
Я же вам говорил!	ru
I want to see your dad.	en
"Umur?" "16."	in
Küçük çatal salata için ve büyük olan ana yemek içindir.	tr
Её история нас очень растрогала.	ru
Мне нравится синее. Сколько оно стоит?	ru
Tomi on pelannut keskipäivästä lähtien tietokonepelejä.	fi
È un vostro problema.	it
La kato estas en la domo.	ep
O adamın Tom'a benzediğini düşünüyorum.	tr
Ho! Patrina amo! Amo, kiun neniu forgesas! Mirinda pano, kiun Dio dividas kaj multobligas! Tablo ĉiam priservita je la patra hejmo! Ĉiu ricevas sian porcion, kaj ĉiuj havas ĝin entute.	ep
Tomo estis punita per sesmonata kondiĉa puno.	ep
Di che colore sono quelli?	it
Nous regardons vos belles images.	fr
Sarete impressionate.	it
Том не смог его найти.	ru
Ist die hebräische Schrift eine Runenschrift?	de
Спасибо, что посмотрел.	ru
Мы знали, чего ожидать.	ru
Io ho visto questo film due volte.	it
Ni ankoraŭ ne gajnis ion.	ep
Vi faris stultaĵon, kiam vi invitis ŝin.	ep
Dovrò avvertire Tom.	it
Я приятно удивлена!	ru
Они возместили ущерб.	ru
Tom não gosta de surpresas.	pt
Ili volas seksumadon, riĉecon kaj gloron.	ep
Tomo etendis koverton al Manjo.	ep
Tom avait l'habitude de passer beaucoup de temps avec ses grands-parents.	fr
Er steht schon seit zwei Jahren unter Hausarrest.	de
Ne kadar yesem de doymuyorum.	tr
Uzun süredir evli değiliz.	tr
Том сказал Мэри, что она хорошенькая.	ru
Том, звичайно ж, талановита дитина.	ua
Je n'attends rien de ta part.	fr
The mistake hastened his retirement.	en
Now that you are no longer young, you must think of your future.	en
Don't push me around.	en
He asked me where she lived.	en
The moment she'd finished, she lay down for a nap.	en
她最多18岁。	zh
Staruszek lubi przesadzać.	pl
Ken möchte ein Fahrrad.	de
Учёный знаменит не только в Японии, но и в других странах.	ru
"Kial vi tiel diligente lernas la anglan?" "Por iĝi angla instruisto."	ep
Die Leiche war bis zur Unkenntlichkeit verbrannt.	de
Tengo hambre porque no he comido.	es
Veuillez allumer la radio.	fr
"Mi instruas al vi la superhomon!" diris Zarathustra.	ep
Li ligis la ŝteliston.	ep
La letero alvenos morgaŭ.	ep
Lassen Sie uns loslegen.	de
Er brach sein Wort.	de
Zabijała czas, chodząc po sklepach.	pl
I tore a hole in my jeans when I fell off my bike.	en
Bitte sagen Sie mir die genaue Zeit.	de
Acho que ela tem quarenta anos.	pt
Ze denken dat hij niet geschikt is voor deze taak.	nl
Ninguém atentou para seus talentos literários.	pt
我把心里话说出来了。	zh
L'homme mange du pain.	fr
Wale wurden für Fische gehalten.	de
Devo scrivere una lettera, ma non potrò farlo fino a domani.	it
Lui è un attore.	it
Byłem przestraszony nie na żarty.	pl
Der Feind nähert sich der Stadt.	de
Kutime, la vilaĝanoj estas malfidemaj kontraŭ fremduloj.	ep
The ship ran aground.	en
Hayat niçin o kadar acı dolu?	tr
Depois de tudo, fiquei com pena dele.	pt
Ich habe Sie verraten.	de
No tan rápido, joven amigo.	es
Eu prefiro vinho tinto a vinho branco.	pt
Tom bir bardak suya bir parça kuru buz koydu.	tr
Animo-o a vir e a ajoelhar-se comigo ao pé da Cruz do Calvário para sermos lavados pelo sangue de Nosso Salvador Jesus Cristo.	pt
Prenu naztukon, via nazo ploras.	ep
Antaŭ precize 50 jaroj Stalin perdis sian lokon en la maŭzoleo.	ep
I've never been religious, but hearing the Lord's Prayer in Latin makes me shudder.	en
La profesoro ridetis.	ep
Post la beno en la preĝejo, ni invitos nur niajn nuptoatestantojn al manĝeto.	ep
Tom ağaçtan indi.	tr
Rusto ronĝas feron, kaj zorgo la homon.	ep
Onların başına bela gelmek üzere.	tr
Pago estas 100 dolaroj plus imposto kontraŭ nokto.	ep
¡Qué alivio!	es
Cosa vi piace fare la domenica?	it
Bom dia. O que deseja?	pt
Ne farendas tiom da bruo pri ĝi.	ep
Eran tiempos peligrosos.	es
Onun işi standartlara uygun değil.	tr
Veux-tu que je t'emmène ?	fr
He always asks for your opinion.	en
His ignorance causes her problems.	en
Tom ĵus estis ĉi tie.	ep
Are you one of Tom's relatives?	en
Daha fazla kurabiye alın.	tr
Почему ты так напугана? Что ты увидела?	ru
¿Sería tan amable de explicarme el camino a la estación?	es
É óbvio que vamos à igreja.	pt
Я хочу воды.	ru
Czy mogę ci pomóc coś znaleźć?	pl
In welchem Hafen sind sie an Bord gegangen?	de
Les cimetières sont pleins de gens indispensables.	fr
Ich arbeitete auf Herrn Woods Bauernhof, als ich jung war.	de
Vocês podem traduzir esta música para mim?	pt
Tiuj tomatoj estas sengustaj.	ep
Человек наделён даром речи.	ru
I can do this.	en
N'importe qui pourrait le faire.	fr
Ich kannte ihn damals nicht.	de
Ich kann Tom nicht dazu bringen, langsamer zu machen.	de
Chi è questa?	it
Let's be careful.	en
Rilassiamoci!	it
Je veux que tu restes où tu es.	fr
Por favor, dame algo para comer.	es
N'aie pas l'air si choquée !	fr
У нас четыре кролика, один из них кусается.	ru
Я слушаю музыку этой группы.	ru
Eles lamentaram a morte do pai.	pt
भरून टाक.	ma
O meu tio me deu um par de sapatos.	pt
Is someone thinking of going to Kos next summer holidays?	en
Smettila di inventarti le cose!	it
Cominciate qui.	it
Ŝia parolmaniero tedas min.	ep
Она побледнела от испуга.	ru
An westlichen Standards gemessen ist unser Haus zu klein.	de
Does Tom understand?	en
Przynajmniej powiedz komu możemy podziękować za naszą wolność!	pl
Lo dimentichi.	it
La spektaklo estis multe vizitata.	ep
Der Flirt ist die Kunst, einer Frau in die Arme zu sinken, ohne ihr in die Hände zu fallen.	de
I didn't mean to take it.	en
Mia avo tre sanas.	ep
Je ne sais pas jouer au tennis.	fr
Mi havis neniun rajton enmiksiĝi.	ep
她说的极其快。	zh
I made certain I wasn't being followed.	en
I really don't think Tom is going to go.	en
Se mi estus en via situacio, mi ne farus ion tian.	ep
Homo, kiu koncentras sin antaŭ artverko, estas absorbita de ĝi. Kontraste la distra homamaso estas absorbita de la artverko.	ep
Serge estas specialisto pri etnografio.	ep
Tom'un iyi bir satranç oyuncusu olduğumu düşündüğüne inanamıyorum.	tr
I have to sell it today.	en
Tom çizburger seviyor mu?	tr
Мы были пассажирами.	ru
Я до сих пор не понимаю, чего вы от меня хотите.	ru
Biz Tom'un sınıf arkadaşlarıyız.	tr
Biz uykuluyuz.	tr
Sag das bitte niemandem!	de
Том не болеет.	ru
É como se tivéssemos perdido nossa identidade.	pt
मूल त्या मोठ्या झाडापाठी लपलेलं.	ma
Он придёт позже.	ru
Tom und Maria suchen Johannes.	de
Tu es blanc comme un cachet d'aspirine.	fr
Forse l'avete fatta sbagliata.	it
Je crains qu'il ne soit en retard.	fr
Li ne devas ellitiĝi tiel frue.	ep
I've always considered Tom a close friend.	en
I need to find somebody who can babysit on Friday nights.	en
Ili riparis brakhorloĝon.	ep
I need to go to Boston.	en
Fortschritt ist die Verwirklichung von Utopien.	de
Tom looked through the peephole in the door.	en
Я думала, что схожу с ума.	ru
С набитым ртом не разговаривают.	ru
К сожалению, к моим предупреждениям не прислушались.	ru
Том постоянно врет Мари.	ru
Venuta la sera, dato che eri un po' stanco, volesti sederti di fronte a una nuova caffetteria situata all'angolo di un nuovo boulevard, ancora pieno di ghiaia e già mostrante i suoi splendori incompiuti.	it
Никто из нас не видел этого.	ru
Gece seni ne uyanık tutar?	tr
Перенос личного опыта на общие явления и попытка выстроить выводы на основании частного - это царский путь научной аргументации.	ru
Sto iniziando a pensare che lei non sia seria.	it
Sinä sanot, että Nessie on mielikuvitusolento, mutta minä uskon, että se on olemassa.	fi
Il m'a dit qu'il voulait pratiquer son anglais avec moi.	fr
Quei due ragazzi condividono la stessa stanza del dormitorio.	it
Il rischio ricade tutto sui trasportatori?	it
That's not even an option.	en
Удивительно, что у Тома нет велосипеда.	ru
Riski biliyordum.	tr
C'était plutôt bien, non ?	fr
Es-tu vraiment malade ?	fr
Это потому, что я люблю тебя.	ru
İçimdeki sonsuzlukta kaybolup kendimi unutmak istiyorum.	tr
Teraz to z pewnością nie ma znaczenia.	pl
Зоология и ботаника занимаются изучением жизни.	ru
I didn't ask you on a date.	en
Ammettete la sconfitta.	it
Was also geschieht der Hauptfigur zuletzt?	de
İşi alacağını hissediyorum.	tr
Noi abbiamo atteso il nostro turno.	it
Tom omistaa oman yrityksensä.	fi
Let me take care of you.	en
Tom è impegnato ora, quindi non riesce a parlare con voi.	it
Io indagavo.	it
Chuck's Diner'daki yemekten hoşlanacağınızı biliyorum.	tr
Siccome era molto freddo, ieri ho indossato un cappello.	it
Tua moglie mi sta insegnando l'italiano.	it
You have to help him.	en
Tom iyi bir nişancı.	tr
Tom refused to work with Mary.	en
Hemen benimle gelmen gerekiyor.	tr
Toplantı ile ilgili rapor hazır.	tr
Did you choose yet?	en
Onlarla takılma.	tr
You do remember that, don't you?	en
Я не сказал, что вы здесь.	ru
Мери работи во салон за нокти.	mk
Stiamo per riprovarlo.	it
Neden gerçekten burada olduğunu neden bana söylemiyorsun?	tr
Lei sta per vedere.	it
Может, Том сможет решить эту проблему.	ru
Ti porteremo.	it
Я расскажу несведущим, как же это случилось.	ru
Сакам да се фатам за работа.	mk
Ми треба некој со когошто ќе можам да се чувствувам безбедно.	mk
Она отвернулась и начала плакать.	ru
Lei la sta tendendo.	it
I was the only man in the tour group. The others were 7 Arab women who live in Istanbul.	en
Ĉu vi bonvolas subskribi ĉi tie?	ep
Ho qualcosa da dire a Tom.	it
Mindenki tudja, hogy gyönyörűen énekelsz.	hu
Том е човекон со долга брада.	mk
Не сакавме да упаднеме.	mk
Tomo permesis al Maria ŝofori sian novan aŭton.	ep
The starting point of all achievement is desire.	en
Elme fel nem foghatja, hogy micsoda erő rejlik a szeretetben.	hu
Jag önskar att jag hade en tvilling.	se
Mitä Tomille ja Marille oikeasti tapahtui?	fi
अशक्य.	ma
Vásárolt egy játékot a fiúnak.	hu
Iel Tomo sciis tion.	ep
Ne edd meg az asztalon lévő tálból a gyümölcsöket! Nem igaziak.	hu
Zor yolu keşfettim.	tr
В прошлом Том испытывал проблемы в общении, не находя никого, кто понял и разделил бы его преданность горностаям, однако всё изменилось, когда он научился пробуждать в других страсть к горностаям с помощью лишь нескольких тщательно выверенных фраз.	ru
Anyagát inkább csak találgatni lehet.	hu
J'ai appris ceci dans les forces spéciales.	fr
Als je succes wil hebben, moet je veel risico's nemen.	nl
Wat voor een invloed heeft de volle maan op jou?	nl
Tu peux te fier à elle.	fr
Tom houdt van sciencefiction.	nl
Hâlâ onları arıyor musun?	tr
Şampanya Fransa'dan ithal edilmektedir.	tr
Saluta Tom.	it
Я одолжу тебе этот словарь.	ru
Kion Tomo ŝuldas al vi?	ep
Не само аз мисля, че Том не трябва да прави това.	bg
У нас особая связь.	ru
Creo que Tom está haciendo trampa.	es
Isso é terrível!	pt
Bir keresinde bir çocukla tanıştım.	tr
To fantastycznie!	pl
Biraz kahve ister misiniz?	tr
Mai rinunciare a tuo sogno.	it
Eu não quero chamar a polícia.	pt
Warum interessiert euch das?	de
Jane Goodall şempanzelerin her şeyi yediklerini, vejetaryen olmadıklarını keşfetti.	tr
A él le encanta dar vueltas por el bosque en su tiempo libre.	es
Eu vou precisar de você.	pt
Ты в кофе сахар кладёшь?	ru
Yapılan zararı telafi etmek için asla çok fazla geç değildir.	tr
Jeg så Mary med ham	dk
Mi konfesas, ke mi ne komprenas tion.	ep
Luck was on our side.	en
La larmoj en la okuloj de la knabineto malarmis min.	ep
Магазин почти пустой.	ru
Questo è un dalmata.	it
Он вёл двойную жизнь.	ru
Hepimizin onu bildiğini düşünüyorum.	tr
Це дуже дорого!	ua
Я весь день ничего не ел, но не голодный.	ru
Mi ne sukcesas fronti kontraŭ tiu problemo nun.	ep
Lavo le mie mele.	it
Robert 'krem brûlée'nin nasıl telaffuz edileceğini bilmiyor.	tr
Вы посадили дерево.	ru
Einem geschenkten Barsch schaut man nicht in die Kiemen.	de
Вы родители Тома, не так ли?	ru
Ambulância é um veículo dotado de aparelhos especiais para transportar pessoas doentes ou feridas ao hospital, especialmente em emergências.	pt
Şimdi yapabileceğimiz tek bir şey var!	tr
Matematik profesörüm uykusuzluktan muzdarip.	tr
Estou começando a entender a ideia.	pt
Je cherche le gérant.	fr
Neki van igaza.	hu
Mi diris "Panjo!", kaj mi ekploregis ...	ep
Nel 1950 la popolazione degli Stati Uniti era di 150 milioni di abitanti.	it
Давай я скажу тебе почему.	ru
Yasaklanmamış şeye izin verilir.	tr
Desearía tener uno.	es
Ne rompu al vi la kapon por tio!	ep
The Anglo-Saxons overran the Celts.	en
J'adore les phrases dont le sujet sont les écureuils !	fr
Vi okupas la ĝustan lokon por scii tion.	ep
Elle a posé une couverture sur moi.	fr
Это совсем на тебя не похоже.	ru
Se ti stai congelando, prendi un'altra coperta.	it
Mi volis paroli pli longe, sed ŝi estis malŝaltinta.	ep
Mi opinias, ke tio estas imponega aranĝo.	ep
Я сам не был до конца уверен.	ru
Everything was great until recently.	en
Non avevo intenzione di comprare niente.	it
Non piangere, sei un uomo.	it
Премного благодарна!	ru
La plej gravaj damaĝoj okazigitaj al Tatoeba konsistas en modifado de ĝustaj frazoj, kiuj havas ĝustajn tradukojn.	ep
Suomen kielessä ei aspiroida konsonantteja k, p ja t.	fi
What's left for Tom?	en
O çok yoğundu.	tr
Verflucht! Nichts gefällt dir.	de
Ve yemeğiniz nasıl?	tr
Lui ha promesso che ci avrebbe aiutate.	it
Dumandan dolayı yaklaşamıyorlar.	tr
Rumahku kotor.	in
O yaşamak istediğim yer.	tr
